comment_count,heat,likes,tags,year,month,weekday,hour,createtime
793,44728,43935,[],2018,4,1,9,2018-04-02 09:56:25
136,32513,32377,[],2018,4,0,16,2018-04-01 16:49:47
86,27640,27554,[],2018,4,0,16,2018-04-01 16:26:08
231,38403,38172,['ATPMasters1000'],2018,4,0,15,2018-04-01 15:45:23
113,24775,24662,[],2018,4,0,15,2018-04-01 15:20:04
47,22430,22383,['MiamiOpen'],2018,4,0,14,2018-04-01 14:25:45
37,15728,15691,[],2018,3,6,18,2018-03-31 18:32:14
170,22209,22039,['MiamiOpen'],2018,3,5,19,2018-03-30 19:31:03
42,19500,19458,[],2018,3,5,17,2018-03-30 17:06:00
167,29851,29684,[],2018,3,5,16,2018-03-30 16:47:33
109,15035,14926,['MiamiOpen'],2018,3,4,20,2018-03-29 20:27:09
76,20788,20712,[],2018,3,4,20,2018-03-29 20:11:45
204,25497,25293,[],2018,3,4,14,2018-03-29 14:52:34
233,22109,21876,[],2018,3,3,19,2018-03-28 19:07:41
194,19778,19584,"['instasport', 'hype', 'saschazverev', 'nickkyrgios', 'miamiopen', 'kyrgios', 'atp', 'tennistv', 'Repost', 'tennis', 'miami', 'sports']",2018,3,2,19,2018-03-27 19:50:04
17,8277,8260,"['instasport', 'nba', 'nickkyrgios', '305', 'miamiopen', 'kyrgios', 'atp', 'tennistv', 'Repost', 'msdstrong', 'tennis', 'atpworldtour', 'celtics']",2018,3,1,16,2018-03-26 16:25:15
76,9437,9361,[],2018,3,1,14,2018-03-26 14:57:33
18,10178,10160,"['hayward', 'miamiopen', 'kyrgios', 'atp', 'msdstrong', 'tennis']",2018,3,0,18,2018-03-25 18:14:59
157,25620,25463,[],2018,3,6,21,2018-03-24 21:25:40
142,25878,25736,[],2018,3,6,19,2018-03-24 19:59:35
18,9252,9234,[],2018,3,6,19,2018-03-24 19:28:47
374,25703,25329,"['instasport', 'atpworldtour', 'miamiopen', 'tennistv', 'atp', 'Repost', 'hotshot', 'tennis', 'miami', 'sports', 'federer', 'rogerfederer']",2018,3,6,18,2018-03-24 18:44:57
352,36219,35867,[],2018,3,6,18,2018-03-24 18:40:35
32,20627,20595,[],2018,3,6,13,2018-03-24 13:56:57
774,40404,39630,"['instasport', 'delpotro', 'miamiopen', 'tennistv', 'atp', 'Repost', 'hotshot', 'tennis', 'miami', 'sports', 'atpworldtour', 'delpo', 'sport']",2018,3,5,22,2018-03-23 22:18:59
66,12677,12611,"['instasport', '305', 'crandonpark', 'miamiopen', 'tennistv', 'Repost', 'tennis', 'raonic', 'milosraonic']",2018,3,5,17,2018-03-23 17:36:45
245,30100,29855,[],2018,3,5,17,2018-03-23 17:34:16
129,15003,14874,[],2018,3,5,12,2018-03-23 12:08:28
32,11305,11273,[],2018,3,4,19,2018-03-22 19:37:51
38,19132,19094,[],2018,3,4,11,2018-03-22 11:24:22
41,10596,10555,[],2018,3,4,10,2018-03-22 10:05:07
25,6401,6376,['ThrowbackThursday'],2018,3,4,9,2018-03-22 09:03:10
77,13940,13863,"['instasport', 'lucky', 'miamiopen', 'tennistv', 'atp', 'Repost', 'tennis', 'miami', 'sports', 'atpworldtour', 'funny']",2018,3,3,18,2018-03-21 18:49:05
40,10301,10261,[],2018,3,3,16,2018-03-21 16:21:44
64,21428,21364,[],2018,3,3,15,2018-03-21 15:24:41
103,14451,14348,['MiamiOpen'],2018,3,3,13,2018-03-21 13:00:59
60,23864,23804,[],2018,3,3,8,2018-03-21 08:00:20
24,10619,10595,[],2018,3,2,16,2018-03-20 16:31:47
81,21092,21011,['MiamiOpen'],2018,3,2,15,2018-03-20 15:49:28
27,8899,8872,[],2018,3,2,15,2018-03-20 15:20:30
152,37570,37418,['MondayMotivation'],2018,3,1,13,2018-03-19 13:06:30
603,61437,60834,[],2018,3,0,20,2018-03-18 20:26:30
188,46601,46413,[],2018,3,0,19,2018-03-18 19:59:33
133,29648,29515,[],2018,3,0,19,2018-03-18 19:28:41
754,62760,62006,['ATPMasters1000'],2018,3,0,18,2018-03-18 18:56:29
127,25410,25283,['ATPMasters1000'],2018,3,0,18,2018-03-18 18:17:56
227,41444,41217,['BNPPO18'],2018,3,0,17,2018-03-18 17:57:13
67,17026,16959,"['BNPPO18', 'TennisParadise']",2018,3,0,17,2018-03-18 17:52:15
162,17333,17171,"['instasport', 'bnpparibasopen', 'indianwells', 'doubles', 'tennistv', 'atp', 'Repost', 'hotshot', 'tennis', 'atpworldtour', 'BNPPPO18', 'sport']",2018,3,0,15,2018-03-18 15:14:23
44,11795,11751,['BNPPO18'],2018,3,0,15,2018-03-18 15:07:38
92,27404,27312,"['Isner', 'bnppo18', 'champions', 'doubles', 'tennis', 'ATP', 'Sock']",2018,3,6,22,2018-03-17 22:59:42
86,35513,35427,"['Laver', 'bnppo18', 'Tennis', 'IndianWells', 'ATP', 'Federer']",2018,3,6,17,2018-03-17 17:40:52
179,40251,40072,[],2018,3,6,16,2018-03-17 16:42:13
132,16604,16472,['SaintPatricksDay'],2018,3,6,9,2018-03-17 09:49:18
115,29774,29659,[],2018,3,5,19,2018-03-16 19:52:47
76,18070,17994,[],2018,3,5,17,2018-03-16 17:22:36
106,18443,18337,"['BNPPO18', 'Haasome', 'FlashbackFriday']",2018,3,5,15,2018-03-16 15:12:06
106,22165,22059,['ATPMasters1000'],2018,3,4,18,2018-03-15 18:50:15
80,14719,14639,[],2018,3,4,15,2018-03-15 15:55:51
79,14894,14815,"['bnpparibasopen', 'indianwells', 'tennistv', 'atp', 'Repost', 'tennis', 'chung', 'BNPPO18', 'atpworldtour']",2018,3,3,19,2018-03-14 19:17:45
71,21863,21792,['NationalPiDay'],2018,3,3,15,2018-03-14 15:13:53
68,24572,24504,[],2018,3,0,20,2018-03-11 20:46:34
114,22527,22413,[],2018,3,0,19,2018-03-11 19:52:12
118,19018,18900,[],2018,3,0,19,2018-03-11 19:16:29
39,8905,8866,[],2018,3,0,15,2018-03-11 15:32:54
43,17147,17104,['NittoATPFinals'],2018,3,0,4,2018-03-11 04:17:37
868,43058,42190,"['tennis', 'Dimitrov', 'BNPPO18', 'ATP']",2018,3,6,22,2018-03-10 22:19:53
81,14229,14148,[],2018,3,6,21,2018-03-10 21:25:31
193,17097,16904,"['TennisParadise', 'throwback', 'tennis', 'BNPPO18', 'ATP']",2018,3,6,18,2018-03-10 18:19:53
37,14259,14222,['BNPPO18'],2018,3,6,16,2018-03-10 16:48:44
119,18156,18037,"['bnppo18', 'Tennis', 'doubles', 'Repost', 'ATP']",2018,3,6,11,2018-03-10 11:23:57
68,10061,9993,"['bnpparibasopen', 'doubles', 'Repost', 'Doubles', 'tennis', 'BNPPO18', 'ATP']",2018,3,6,0,2018-03-10 00:43:57
52,12201,12149,"['tennis', 'ATPMasters1000', 'BNPPO18', 'ATP']",2018,3,5,23,2018-03-09 23:23:12
75,18110,18035,[],2018,3,5,19,2018-03-09 19:25:50
20,5499,5479,[],2018,3,5,16,2018-03-09 16:02:40
52,12963,12911,[],2018,3,5,13,2018-03-09 13:32:56
133,13771,13638,"['instasport', 'fridayfeeling', 'bnppo18', 'indianwells', 'paire', 'tweener', 'tennistv', 'trickshot', 'hotshot', 'tennis', 'sports']",2018,3,5,11,2018-03-09 11:43:19
277,21709,21432,"['bnpparibasopen', 'instasport', 'NextGenATP', 'tennistv', 'atp', 'Repost', 'tennis', 'BNPPO18', 'atpworldtour', 'sport']",2018,3,5,11,2018-03-09 11:33:23
22,20173,20151,['ThrowbackThursday'],2018,3,4,18,2018-03-08 18:24:23
11,11558,11547,['TennisParadise'],2018,3,4,18,2018-03-08 18:15:57
104,14746,14642,[],2018,3,4,17,2018-03-08 17:49:43
356,32038,31682,[],2018,3,3,16,2018-03-07 16:55:42
24,9040,9016,['NextGenATP'],2018,3,2,22,2018-03-06 22:56:38
46,10197,10151,[],2018,3,1,9,2018-03-05 09:07:28
14,9344,9330,"['Delbonis', 'champions', 'BrasilOpen2018', 'doubles', 'tennis', 'ATP', 'Gonzalez']",2018,3,0,16,2018-03-04 16:15:23
62,12501,12439,"['instasport', 'mexico', 'atpworldtour', 'delpotro', 'tennistv', 'atp', 'Repost', 'tennis', 'acapulco', 'delpo', 'sport']",2018,3,0,15,2018-03-04 15:05:11
97,26382,26285,"['Fognini', 'champion', 'BrasilOpen2018', 'tennis', 'ATP', 'singles']",2018,3,0,13,2018-03-04 13:49:47
121,32607,32486,"['AMT2018', 'Delpo', 'Acapulco', 'champion', 'DelPotro', 'tennis', 'ATP', 'singles']",2018,3,0,12,2018-03-04 12:14:12
9,11372,11363,"['AMT2018', 'Acapulco', 'Soares', 'champions', 'doubles', 'Murray', 'tennis', 'ATP']",2018,3,0,12,2018-03-04 12:05:38
212,21452,21240,"['SaoPaulo', 'BrasilOpen', 'balldogs', 'tennis', 'ATP', 'dogs']",2018,3,6,18,2018-03-03 18:09:05
34,14648,14614,"['DDFTennis', 'Dubai', 'champion', 'BautistaAgut', 'tennis', 'ATP', 'singles']",2018,3,6,17,2018-03-03 17:05:22
30,10944,10914,"['DDFTennis', 'Dubai', 'champions', 'doubles', 'tennis', 'ATP']",2018,3,6,16,2018-03-03 16:51:44
84,14843,14759,"['tennis', 'SaoPaulo', 'ATP', 'Jarry']",2018,3,5,23,2018-03-02 23:53:08
58,18737,18679,"['Murray', 'britain', 'snow', 'tennis', 'ATP', 'sports', 'snowman', 'beastfromtheeast']",2018,3,4,16,2018-03-01 16:30:40
377,18461,18084,"['tennis', 'Paire', 'ATP', 'DDFTennis']",2018,2,3,21,2018-02-28 21:02:17
512,49984,49472,"['Laureus18', 'Repost']",2018,2,2,15,2018-02-27 15:41:45
53,11449,11396,[],2018,2,2,15,2018-02-27 15:02:23
69,19791,19722,"['AMT2018', 'Thiem', 'Acapulco', 'Zverev', 'tennis', 'ATP']",2018,2,1,19,2018-02-26 19:02:39
38,13365,13327,"['Dimitrov', 'DDFTennis', 'Dubai', 'zipline', 'tennis', 'ATP']",2018,2,1,17,2018-02-26 17:26:53
106,23983,23877,"['DBO2018', 'Tiafoe', 'champion', 'NextGenATP', 'DelrayBeach', 'tennis', 'ATP']",2018,2,0,20,2018-02-25 20:20:46
158,32562,32404,"['RioOpen', 'champion', 'Schwartzman', 'tennis', 'ATP']",2018,2,0,18,2018-02-25 18:44:17
9,9844,9835,"['DBO2018', 'champion', 'DelrayBeachOpen', 'doubles', 'tennis', 'ATP', 'Withrow', 'Sock']",2018,2,0,16,2018-02-25 16:22:53
33,15211,15178,"['champion', 'NextGenATP', 'Khachanov', 'tennis', 'ATP', 'Marseille']",2018,2,0,12,2018-02-25 12:10:05
29,15442,15413,"['Verdasco', 'RioOpen', 'champions', 'doubles', 'Marrero', 'tennis', 'ATP']",2018,2,0,11,2018-02-25 11:47:09
18,7736,7718,"['Venus', 'doubles', 'Klaasen', 'tennis', 'ATP', 'Marseille']",2018,2,0,11,2018-02-25 11:14:29
116,12532,12416,"['proposal', 'Rio', 'RioOpen', 'engagement', 'tennis', 'ATP']",2018,2,6,13,2018-02-24 13:30:27
28,14031,14003,"['DBO2018', 'Tiafoe', 'Opelka', 'Shapovalov', 'NextGenATP', 'Fritz', 'DelrayBeach', 'Chung', 'tennis', 'ATP']",2018,2,5,12,2018-02-23 12:31:44
104,9475,9371,"['Thiem', 'blooper', 'RioOpen', 'Schwartzman', 'ArgentinaOpen', 'tennis', 'ATP']",2018,2,3,11,2018-02-21 11:26:00
82,14772,14690,"['brasil', 'riodejaneiro', 'rio', 'rioopen2018', 'tweener', 'tennistv', 'trickshot', 'Repost', 'hotshot', 'tennis', 'TweenerTuesday', 'atp', 'brazil', 'sports', 'atpworldtour', 'sport']",2018,2,2,20,2018-02-20 20:58:15
1002,38859,37857,"['tennis', 'ATP', 'RioOpen', 'Fognini']",2018,2,1,22,2018-02-19 22:38:41
62,16443,16381,"['RioOpen', 'footvolley', 'Schwartzman', 'tennis', 'ATP', 'Brazil']",2018,2,1,12,2018-02-19 12:57:32
133,28090,27957,['Rolex'],2018,2,1,12,2018-02-19 12:07:14
3,3782,3779,"['NextGenATP', 'Open13', 'tennis', 'ATP', 'Marseille']",2018,2,1,11,2018-02-19 11:17:06
165,22693,22528,['Repost'],2018,2,1,10,2018-02-19 10:31:31
187,13515,13328,[],2018,2,1,9,2018-02-19 09:18:41
34,11307,11273,"['DBO2018', 'DelrayBeachOpen', 'Raonic', 'tennis', 'ATP']",2018,2,0,19,2018-02-18 19:34:47
34,13643,13609,"['NewYork', 'Anderson', 'champion', 'NYOpen', 'tennis', 'ATP']",2018,2,0,19,2018-02-18 19:16:28
38,11611,11573,"['RioOpen2018', 'Rio', 'Carnival', 'tennis', 'ATP']",2018,2,0,18,2018-02-18 18:47:38
10,7070,7060,"['Oswald', 'Mirnyi', 'champions', 'doubles', 'NYOpen', 'tennis', 'ATP']",2018,2,0,17,2018-02-18 17:36:51
82,22091,22009,"['Thiem', 'BuenosAires', 'champion', 'ArgentinaOpen', 'tennis', 'ATP']",2018,2,0,16,2018-02-18 16:35:44
13,7257,7244,"['BuenosAires', 'champions', 'doubles', 'tennis', 'ATP']",2018,2,0,16,2018-02-18 16:23:13
14,7262,7248,"['Mirnyi', 'doubles', 'NYOpen', 'tennis', 'ATP', 'milestone']",2018,2,0,11,2018-02-18 11:41:16
97,27862,27765,"['winning', 'rogerfederer', 'trophy', 'champion', 'tennistv', 'Repost', 'tennis', 'sports', 'federer', 'sport']",2018,2,0,11,2018-02-18 11:21:14
10,11185,11175,"['Mahut', 'Rotterdam', 'champions', 'doubles', 'tennis', 'ATP', 'abnamrowtt', 'Herbert']",2018,2,0,11,2018-02-18 11:17:46
315,19068,18753,"['davidgoffin', 'injury', 'rotterdam', 'dimitrov', 'goffin', 'tennistv', 'atp', 'Repost', 'tennis', 'sports', 'atpworldtour', 'abnamrowtt', 'sport']",2018,2,6,21,2018-02-17 21:16:58
37,14066,14029,"['DBO2018', 'Shapovalov', 'DelrayBeachOpen', 'Chung', 'tennis', 'ATP']",2018,2,6,19,2018-02-17 19:27:53
309,72075,71766,[],2018,2,5,15,2018-02-16 15:44:16
379,43590,43211,[],2018,2,5,15,2018-02-16 15:11:35
1261,91980,90719,[],2018,2,5,15,2018-02-16 15:03:08
387,29314,28927,"['Rotterdam', 'hotshot', 'tennis', 'ATP', 'sports', 'atpworldtour', 'abnamrowtt', 'Federer']",2018,2,4,0,2018-02-15 00:20:29
30,11806,11776,"['rotterdam', 'atp', 'sugita', 'hotshot', 'tennis', 'atpworldtour']",2018,2,4,0,2018-02-15 00:14:01
31,19236,19205,"['Dimitrov', 'Goffin', 'Rotterdam', 'Rublev', 'tennis', 'ATP', 'abnamrowtt', 'Federer']",2018,2,3,18,2018-02-14 18:26:03
40,4033,3993,['HappyValentinesDay'],2018,2,3,14,2018-02-14 14:08:08
12,5666,5654,"['500series', 'Thiem', 'Nadal', 'Cilic', 'tennis', 'ATP', 'Federer']",2018,2,3,10,2018-02-14 10:49:34
109,9673,9564,"['instasport', 'mlb', 'baseball', 'tennistv', 'atp', 'Repost', 'tennis', 'sports', 'atpworldtour', 'sport']",2018,2,2,15,2018-02-13 15:34:50
149,24515,24366,"['tennis', 'ATP', 'Rotterdam', 'Federer']",2018,2,1,5,2018-02-12 05:05:31
62,12014,11952,"['tennis', 'Quito', 'ATP', 'tenislatitudcero']",2018,2,0,19,2018-02-11 19:05:12
13,7539,7526,"['tennis', 'ATP', 'NYOpen', 'BrooklynNets']",2018,2,0,18,2018-02-11 18:21:13
42,11749,11707,"['tennis', 'SofiaOpen', 'ATP', 'champion']",2018,2,0,15,2018-02-11 15:59:29
26,9741,9715,"['champions', 'TenisLatitudCero', 'doubles', 'tennis', 'ATP']",2018,2,0,12,2018-02-11 12:23:14
48,16372,16324,"['champion', 'OSDF18', 'Pouille', 'tennis', 'ATP']",2018,2,0,12,2018-02-11 12:05:41
19,8895,8876,"['tennis', 'doubles', 'ATP', 'OSDF18']",2018,2,0,12,2018-02-11 12:01:35
22,10282,10260,"['SofiaOpen', 'Middelkoop', 'doubles', 'tennis', 'Haase', 'ATP']",2018,2,0,11,2018-02-11 11:37:23
33,17072,17039,"['tennis', 'ATP', 'OSDF17', 'Gaquet']",2018,2,6,14,2018-02-10 14:02:38
69,21427,21358,"['tennis', 'FridayFeeling', 'ATP', 'Federer']",2018,2,5,17,2018-02-09 17:54:51
68,15294,15226,"['atpworldtour', 'showman', 'lamonf', 'tennistv', 'atp', 'Repost', 'gaelmonfils', 'tennis', 'quito', 'sports', 'monfils', 'sport']",2018,2,4,18,2018-02-08 18:09:45
53,13572,13519,"['tennis', 'NittoATPFinals', 'London', 'ATP']",2018,2,4,8,2018-02-08 08:48:33
97,29839,29742,"['tennis', 'Wawrinka', 'ATP', 'SofiaOpen']",2018,2,3,14,2018-02-07 14:19:39
24,10138,10114,"['tennis', 'NittoATPFinals', 'London', 'ATP']",2018,2,3,4,2018-02-07 04:00:03
58,13522,13464,"['tenislatitudcero', 'Quito', 'equator', 'tennis', 'ATP']",2018,2,2,19,2018-02-06 19:40:57
77,16807,16730,['NittoATPFinals'],2018,2,2,4,2018-02-06 04:24:32
12,7631,7619,"['tennis', 'Sofia', 'SofiaOpen', 'ATP']",2018,2,1,17,2018-02-05 17:32:18
29,11028,10999,"['Quito', 'TenisLatitudCero', 'Karlovic', 'tennis', 'ATP', 'DutraSilva']",2018,2,0,16,2018-02-04 16:55:25
83,21653,21570,"['tennis', 'Nishikori', 'ATP', 'ATPChallenger']",2018,2,5,18,2018-02-02 18:20:43
177,31257,31080,['Repost'],2018,2,5,17,2018-02-02 17:51:47
522,45675,45153,"['FlashbackFriday', 'GrandSlam', 'tennis', 'ATP', 'Federer']",2018,2,5,11,2018-02-02 11:29:14
27,8255,8228,['NittoATPFinals'],2018,2,4,14,2018-02-01 14:00:11
38,28774,28736,"['champion', 'tennis', 'Switzerland', 'ATP', 'AusOpen', 'Federer']",2018,2,4,11,2018-02-01 11:28:01
64,33299,33235,"['champion', 'weekend', 'tennis', 'ATP', 'AusOpen', 'Federer']",2018,1,3,16,2018-01-31 16:10:42
238,5665,5427,"['tennis', 'iphone', 'ATP', 'animoji']",2018,1,2,17,2018-01-30 17:06:24
32,9648,9616,"['tennis', 'NittoATPFinals', 'London', 'ATP']",2018,1,2,15,2018-01-30 15:43:39
60,17169,17109,"['tennis', 'kyrgios', 'atp', 'ausopen', 'charity']",2018,1,2,9,2018-01-30 09:33:07
169,73646,73477,"['tennis', 'AusOpen', 'atp', 'federer']",2018,1,0,23,2018-01-28 23:37:39
76,49078,49002,"['tennis', 'AusOpen', 'atp', 'federer']",2018,1,0,17,2018-01-28 17:10:54
531,49815,49284,"['chrishemsworth', 'CaptionThis', 'thor', 'atp', 'ausopen', 'tennis', 'federer']",2018,1,0,11,2018-01-28 11:32:09
211,75585,75374,"['moetchandon', 'bts', 'celebration', 'behindthescenes', 'atp', 'ausopen', 'tennis', 'federer', 'MoetMoment']",2018,1,0,10,2018-01-28 10:46:11
88,46362,46274,"['bts', 'behindthescenes', 'atp', 'ausopen', 'squadgoals', 'tennis', 'ljubicic', 'severinluthi', 'federer']",2018,1,0,10,2018-01-28 10:16:26
445,62363,61918,"['atp', 'ausopen', 'Repost', 'tennis', 'federer', 'speech']",2018,1,0,9,2018-01-28 09:41:20
8,10378,10370,"['dabrowski', 'doubles', 'atp', 'ausopen', 'pavic', 'tennis']",2018,1,0,9,2018-01-28 09:38:00
113,48484,48371,[],2018,1,0,9,2018-01-28 09:25:54
946,130085,129139,"['RelationshipGoals', 'tennis', 'ATP', 'AusOpen', 'Federer']",2018,1,0,8,2018-01-28 08:51:55
78,43075,42997,"['tennis', 'ATP', 'AusOpen', 'Federer']",2018,1,0,8,2018-01-28 08:34:10
183,52196,52013,"['Cilic', 'tennis', 'ATP', 'AusOpen', 'Federer']",2018,1,0,8,2018-01-28 08:08:07
165,59581,59416,"['20', 'normaniscominghome', 'Repost', 'ausopen', 'AusOpen']",2018,1,0,7,2018-01-28 07:30:36
237,82069,81832,"['champion', 'tennis', 'ATP', 'AusOpen', 'Federer']",2018,1,0,7,2018-01-28 07:13:23
695,113723,113028,[],2018,1,0,6,2018-01-28 06:51:29
203,54871,54668,"['ausopen', 'Repost']",2018,1,6,9,2018-01-27 09:21:35
31,11527,11496,"['pavic', 'atp', 'ausopen', 'tennis', 'marach']",2018,1,6,9,2018-01-27 09:18:16
72,18445,18373,"['tennis', 'korda', 'ausopen']",2018,1,5,23,2018-01-26 23:39:48
79,15468,15389,"['atpchallenger', 'newport', 'tweener', 'atp', 'hotshot', 'tennis']",2018,1,5,11,2018-01-26 11:47:01
270,36009,35739,"['cilic', 'atp', 'ausopen', 'tennis', 'finalists', 'federer']",2018,1,5,10,2018-01-26 10:46:13
120,34240,34120,"['Chung', 'tennis', 'ATP', 'AusOpen', 'Federer']",2018,1,5,6,2018-01-26 06:02:14
204,46786,46582,"['AustraliaDay', 'tennis', 'ATP', 'AusOpen', 'Federer']",2018,1,5,5,2018-01-26 05:43:40
92,14476,14384,"['atp', 'ausopen', 'preview', 'tennis', 'chung', 'federer']",2018,1,4,17,2018-01-25 17:06:12
142,36301,36159,"['ThrowbackThursday', 'tbt', 'atp', 'ausopen', 'tennis', 'federer']",2018,1,4,12,2018-01-25 12:43:12
15,14159,14144,"['travel', 'australia', 'melbourne', 'atp', 'ausopen', 'tennis', 'views', 'sunset']",2018,1,4,12,2018-01-25 12:00:32
40,11752,11712,"['victory', 'farah', 'cabal', 'celebration', 'doubles', 'pavic', 'atp', 'ausopen', 'tennis', 'marach', 'finalists']",2018,1,4,10,2018-01-25 10:16:13
13,12853,12840,"['tennis', 'edmund', 'atp', 'ausopen']",2018,1,4,7,2018-01-25 07:06:21
49,14401,14352,"['tennis', 'cilic', 'atp', 'ausopen']",2018,1,4,6,2018-01-25 06:59:52
73,16502,16429,"['tennis', 'ATP', 'ausopen', 'Cilic']",2018,1,4,6,2018-01-25 06:25:30
32,10122,10090,"['tennis', 'Chung', 'ATP', 'AusOpen']",2018,1,4,5,2018-01-25 05:04:30
52,14815,14763,"['southkorea', 'atp', 'tennis', 'chung', 'AusOpen', 'milestone']",2018,1,3,18,2018-01-24 18:01:01
48,12523,12475,"['farah', 'cabal', 'doubles', 'ThatWinningFeeling', 'atp', 'ausopen', 'tennis']",2018,1,3,11,2018-01-24 11:49:20
645,60148,59503,"['friends', 'class', 'nadal', 'atp', 'ausopen', 'respect', 'tennis', 'federer']",2018,1,3,10,2018-01-24 10:22:33
38,14717,14679,"['Britain', 'australia', 'melbourne', 'Repost', 'ausopen']",2018,1,3,9,2018-01-24 09:51:17
425,31989,31564,"['edmund', 'cilic', 'atp', 'ausopen', 'tennis', 'chung', 'federer']",2018,1,3,9,2018-01-24 09:47:34
404,40757,40353,"['atp', 'ausopen', 'tennis', 'chung', 'federer']",2018,1,3,9,2018-01-24 09:40:59
64,26508,26444,"['ausopen', 'Repost']",2018,1,3,8,2018-01-24 08:16:07
173,22630,22457,"['family', 'moms', 'atp', 'ausopen', 'hyeonchung', 'tennis']",2018,1,3,0,2018-01-24 00:04:27
188,32550,32362,"['tennis', 'atp', 'ausopen', 'hyeonchung']",2018,1,2,23,2018-01-23 23:42:07
20,8442,8422,['GameInsightGroup'],2018,4,5,3,2018-04-06 03:29:30
12,4704,4692,"['AusOpen', 'IDSDP2018']",2018,4,4,22,2018-04-05 22:22:07
12,6300,6288,['AusOpen'],2018,4,3,21,2018-04-04 21:42:14
161,14472,14311,['AusOpen'],2018,4,3,19,2018-04-04 19:38:34
36,13325,13289,['AusOpen'],2018,4,2,21,2018-04-03 21:39:40
73,8749,8676,['AusOpen'],2018,4,2,2,2018-04-03 02:01:59
16,7673,7657,['AusOpen'],2018,4,2,1,2018-04-03 01:23:52
80,20052,19972,"['AusOpen', 'MondayMotivation']",2018,4,1,3,2018-04-02 03:45:16
10,5267,5257,['AusOpen'],2018,4,0,20,2018-04-01 20:39:17
121,10606,10485,['AusOpen'],2018,3,5,18,2018-03-30 18:51:02
23,6576,6553,['AusOpen'],2018,3,4,1,2018-03-29 01:52:44
168,14477,14309,['AusOpen'],2018,3,3,3,2018-03-28 03:03:24
29,8163,8134,['AusOpen'],2018,3,3,0,2018-03-28 00:09:42
242,16839,16597,['MiamiOpen'],2018,3,1,23,2018-03-26 23:46:33
23,6106,6083,"['AusOpen', 'MondayMotivation']",2018,3,1,4,2018-03-26 04:50:51
127,25164,25037,[],2018,3,0,5,2018-03-25 05:02:30
48,15208,15160,[],2018,3,0,3,2018-03-25 03:11:52
125,13254,13129,"['AusOpen', 'FlashbackFriday']",2018,3,5,2,2018-03-23 02:12:10
11,4943,4932,"['AusGP', 'AusOpen']",2018,3,3,22,2018-03-21 22:04:49
44,8642,8598,['AusOpen'],2018,3,3,18,2018-03-21 18:39:08
200,10205,10005,['GameInsightGroup'],2018,3,3,4,2018-03-21 04:35:21
369,19522,19153,['GameInsightGroup'],2018,3,3,2,2018-03-21 02:15:42
16,8023,8007,['AusOpen'],2018,3,2,19,2018-03-20 19:55:31
13,6188,6175,['AusOpen'],2018,3,2,1,2018-03-20 01:05:16
27,13387,13360,[],2018,3,1,19,2018-03-19 19:32:43
23,9026,9003,[],2018,3,1,1,2018-03-19 01:07:27
93,22436,22343,['BNPPO18'],2018,3,0,22,2018-03-18 22:39:20
66,20676,20610,['AusOpen'],2018,3,5,0,2018-03-16 00:48:59
49,20871,20822,['AusOpen'],2018,3,4,23,2018-03-15 23:36:26
223,19474,19251,['AusOpen'],2018,3,3,21,2018-03-14 21:43:14
78,14237,14159,[],2018,3,2,22,2018-03-13 22:27:45
46,12422,12376,['AusOpen'],2018,3,1,22,2018-03-12 22:08:24
21,9180,9159,['AusOpen'],2018,3,5,18,2018-03-09 18:55:59
70,10575,10505,"['AusOpen', 'FlashbackFriday']",2018,3,5,2,2018-03-09 02:45:34
18,4785,4767,['AusOpen'],2018,3,4,22,2018-03-08 22:00:42
18,5747,5729,"['pojd', 'AusOpen']",2018,3,4,3,2018-03-08 03:14:16
23,5474,5451,['AusOpen'],2018,3,3,0,2018-03-07 00:36:34
14,4372,4358,['AusOpen'],2018,3,2,0,2018-03-06 00:16:59
68,8704,8636,['Oscars'],2018,3,1,1,2018-03-05 01:24:21
20,8178,8158,['Oscars'],2018,3,0,18,2018-03-04 18:47:50
79,20646,20567,"['Oscars', 'AusOpen']",2018,3,0,18,2018-03-04 18:14:02
1285,26801,25516,['Oscars'],2018,3,0,2,2018-03-04 02:12:06
2350,34614,32264,['Oscars'],2018,3,6,0,2018-03-03 00:07:30
35,9493,9458,"['AusOpen', 'WorldWildlifeDay']",2018,3,5,21,2018-03-02 21:13:07
1220,15576,14356,['Oscars'],2018,3,5,3,2018-03-02 03:32:03
117,15003,14886,"['AusOpen', 'FlashbackFriday']",2018,3,5,0,2018-03-02 00:03:01
84,18116,18032,"['Repost', 'stretching', 'travel']",2018,3,4,19,2018-03-01 19:28:13
28,8757,8729,['AusOpen'],2018,3,4,2,2018-03-01 02:09:34
13,4712,4699,"['WorldComplimentDay', 'AusOpen']",2018,2,3,19,2018-02-28 19:24:51
51,10989,10938,[],2018,2,3,1,2018-02-28 01:09:57
11,3908,3897,[],2018,2,2,22,2018-02-27 22:43:22
66,14655,14589,"['AusOpen', 'Laureus18']",2018,2,2,16,2018-02-27 16:05:26
98,19331,19233,"['AusOpen', 'Laureus18']",2018,2,2,15,2018-02-27 15:15:20
49,8354,8305,"['AusOpen', 'Laureus18']",2018,2,2,14,2018-02-27 14:42:28
16,7487,7471,"['AusOpen', 'TweenerTuesday']",2018,2,1,21,2018-02-26 21:57:36
36,7142,7106,['AusOpen'],2018,2,1,3,2018-02-26 03:27:11
33,5317,5284,[],2018,2,0,6,2018-02-25 06:06:19
91,14307,14216,['AusOpen'],2018,2,5,4,2018-02-23 04:31:48
43,17926,17883,['AusOpen'],2018,2,3,22,2018-02-21 22:48:09
106,17169,17063,['AusOpen'],2018,2,2,2,2018-02-20 02:30:57
382,54921,54539,[],2018,2,5,15,2018-02-16 15:28:02
50,8465,8415,['AusOpen'],2018,2,4,23,2018-02-15 23:59:54
74,23352,23278,[],2018,2,4,18,2018-02-15 18:19:56
25,11343,11318,['AusOpen'],2018,2,3,21,2018-02-14 21:02:57
12,11907,11895,"['AusOpen', 'ValentinesDay']",2018,2,3,17,2018-02-14 17:33:32
119,31844,31725,"['AusOpen', 'ValentinesDay']",2018,2,3,1,2018-02-14 01:39:47
7,4497,4490,['AusOpen'],2018,2,2,17,2018-02-13 17:56:01
11,5490,5479,['AusOpen'],2018,2,1,23,2018-02-12 23:50:21
176,24991,24815,[],2018,2,1,1,2018-02-12 01:00:02
55,24111,24056,"['flasbackfriday', 'AusOpen']",2018,2,4,20,2018-02-08 20:13:00
31,12222,12191,['AusOpen'],2018,2,4,2,2018-02-08 02:20:01
36,13307,13271,['AusOpen'],2018,2,3,1,2018-02-07 01:17:09
20,15194,15174,['AusOpen'],2018,2,2,0,2018-02-06 00:27:02
74,37644,37570,['AusOpen'],2018,2,0,18,2018-02-04 18:25:15
110,40953,40843,"['RF20', 'AusOpen']",2018,1,0,23,2018-01-28 23:21:35
147,48373,48226,"['RF20', 'AusOpen']",2018,1,0,19,2018-01-28 19:21:59
232,32915,32683,"['RF20', 'AusOpen', 'Rolex']",2018,1,0,16,2018-01-28 16:19:24
108,57532,57424,['ausopen'],2018,1,0,14,2018-01-28 14:42:38
316,19014,18698,"['AusOpen', 'beheardberecognised']",2018,1,0,13,2018-01-28 13:15:12
66,24553,24487,['ausopen'],2018,1,0,12,2018-01-28 12:05:47
182,58794,58612,"['RF20', 'ausopen']",2018,1,0,10,2018-01-28 10:48:10
36,22483,22447,['AusOpen'],2018,1,0,10,2018-01-28 10:02:55
108,46039,45931,['ausopen'],2018,1,0,9,2018-01-28 09:08:12
79,40179,40100,['ausopen'],2018,1,0,7,2018-01-28 07:48:20
167,39100,38933,"['RF20', 'AusOpen']",2018,1,0,7,2018-01-28 07:23:04
364,80363,79999,"['ausopen', 'RF20']",2018,1,0,7,2018-01-28 07:16:43
908,102823,101915,"['ausopen', 'RF20']",2018,1,0,6,2018-01-28 06:48:14
134,19326,19192,['ausopen'],2018,1,0,6,2018-01-28 06:24:13
250,48881,48631,['ausopen'],2018,1,0,5,2018-01-28 05:49:30
63,18607,18544,['ausopen'],2018,1,0,5,2018-01-28 05:16:29
31,15196,15165,['ausopen'],2018,1,0,4,2018-01-28 04:41:02
83,29793,29710,['ausopen'],2018,1,0,4,2018-01-28 04:11:30
71,9963,9892,['ausopen'],2018,1,0,3,2018-01-28 03:52:01
194,26632,26438,['ausopen'],2018,1,0,3,2018-01-28 03:28:01
41,8832,8791,['ausopen'],2018,1,0,2,2018-01-28 02:21:13
21,3446,3425,['AOLiveStage'],2018,1,0,1,2018-01-28 01:27:59
46,20851,20805,['ausopen'],2018,1,0,1,2018-01-28 01:26:05
9,4427,4418,"['BarillaAO', 'AusOpen', 'MastersOfPasta']",2018,1,0,1,2018-01-28 01:14:51
42,11648,11606,['AusOpen'],2018,1,0,0,2018-01-28 00:32:30
42,14953,14911,['ausopen'],2018,1,0,0,2018-01-28 00:01:03
160,45667,45507,['AusOpen'],2018,1,6,23,2018-01-27 23:36:09
9,4895,4886,"['KiaTennis', 'AusOpen']",2018,1,6,22,2018-01-27 22:49:22
63,20963,20900,['ausopen'],2018,1,6,22,2018-01-27 22:21:56
10,5504,5494,['AusOpen'],2018,1,6,18,2018-01-27 18:59:42
22,8675,8653,['beheardberecognised'],2018,1,6,15,2018-01-27 15:40:14
32,12736,12704,['ausopen'],2018,1,6,14,2018-01-27 14:45:09
12,6933,6921,['ausopen'],2018,1,6,13,2018-01-27 13:18:02
2,3983,3981,['mastercardau'],2018,1,6,12,2018-01-27 12:13:41
14,10353,10339,['ausopen'],2018,1,6,11,2018-01-27 11:02:25
324,35903,35579,['ausopen'],2018,1,6,10,2018-01-27 10:13:57
118,35550,35432,['ausopen'],2018,1,6,9,2018-01-27 09:27:06
61,23416,23355,['ausopen'],2018,1,6,7,2018-01-27 07:53:18
249,46123,45874,['ausopen'],2018,1,6,7,2018-01-27 07:09:26
420,49176,48756,['ausopen'],2018,1,6,6,2018-01-27 06:35:58
66,13632,13566,['ausopen'],2018,1,6,6,2018-01-27 06:04:38
65,12161,12096,['ausopen'],2018,1,6,5,2018-01-27 05:48:23
8,3609,3601,"['kiatennis', 'AusOpen']",2018,1,6,5,2018-01-27 05:23:09
130,20834,20704,['ausopen'],2018,1,6,5,2018-01-27 05:13:13
53,14025,13972,['ausopen'],2018,1,6,4,2018-01-27 04:27:53
62,13095,13033,['ausopen'],2018,1,6,3,2018-01-27 03:54:30
10,2561,2551,"['AusOpen', 'Chains']",2018,1,6,3,2018-01-27 03:44:02
97,6606,6509,['ausopen'],2018,1,6,3,2018-01-27 03:07:49
33,9005,8972,['ausopen'],2018,1,6,2,2018-01-27 02:28:07
184,56033,55849,['AusOpen'],2018,1,6,2,2018-01-27 02:22:22
7,3171,3164,"['BarillaAO', 'AusOpen', 'MastersOfPasta']",2018,1,6,1,2018-01-27 01:54:14
38,11794,11756,['ausopen'],2018,1,6,1,2018-01-27 01:49:17
11,2650,2639,"['AOLiveStage', 'AusOpen']",2018,1,6,0,2018-01-27 00:46:50
35,16711,16676,['ausopen'],2018,1,6,0,2018-01-27 00:43:09
3,3070,3067,"['VisitMelbourne', 'AusOpen', 'visitvictoria', 'Melbourne']",2018,1,6,0,2018-01-27 00:26:18
43,11058,11015,['ausopen'],2018,1,5,23,2018-01-26 23:15:40
23,5120,5097,['ausopen'],2018,1,5,22,2018-01-26 22:22:46
10,4014,4004,['AusOpen'],2018,1,5,21,2018-01-26 21:55:14
12,4718,4706,"['KiaTennis', 'Murray', 'AusOpen']",2018,1,5,18,2018-01-26 18:20:11
7,4547,4540,['AusOpen'],2018,1,5,15,2018-01-26 15:37:35
22,8978,8956,['ausopen'],2018,1,5,14,2018-01-26 14:17:40
63,11079,11016,['ausopen'],2018,1,5,12,2018-01-26 12:50:22
4,3701,3697,"['BeAWellBeing', 'Blackmores']",2018,1,5,11,2018-01-26 11:52:50
16,5987,5971,['ausopen'],2018,1,5,10,2018-01-26 10:31:28
219,32094,31875,['ausopen'],2018,1,5,9,2018-01-26 09:33:55
114,20302,20188,['ausopen'],2018,1,5,8,2018-01-26 08:15:27
32,9141,9109,['ausopen'],2018,1,5,7,2018-01-26 07:09:12
27,6034,6007,['AusOpen'],2018,1,5,6,2018-01-26 06:25:22
154,14736,14582,['beheardberecognised'],2018,1,5,5,2018-01-26 05:40:56
254,34483,34229,['ausopen'],2018,1,5,4,2018-01-26 04:54:28
12,4103,4091,"['visitmelbourne', 'melbournetwist']",2018,1,5,4,2018-01-26 04:27:18
250,19557,19307,"['ausopen', '6']",2018,1,5,3,2018-01-26 03:19:26
42,12722,12680,['ausopen'],2018,1,5,2,2018-01-26 02:42:41
14,7809,7795,['ausopen'],2018,1,5,1,2018-01-26 01:22:34
5,2485,2480,"['KiaTennis', 'AusOpen']",2018,1,5,1,2018-01-26 01:15:23
7,2107,2100,"['AperolSpritzAU', 'ClubAperol']",2018,1,5,0,2018-01-26 00:20:40
8,3698,3690,['AusOpen'],2018,1,5,0,2018-01-26 00:05:22
122,15715,15593,['ausopen'],2018,1,5,0,2018-01-26 00:00:18
3,2219,2216,['AOLiveStage'],2018,1,4,22,2018-01-25 22:15:32
8,4128,4120,"['BarillaAO', 'AusOpen', 'MastersOfPasta']",2018,1,4,20,2018-01-25 20:53:55
215,26272,26057,"['CaptionThis', 'AusOpen']",2018,1,4,18,2018-01-25 18:57:47
11,3143,3132,['AusOpen'],2018,1,4,18,2018-01-25 18:27:19
13,7474,7461,['ausopen'],2018,1,4,15,2018-01-25 15:08:04
40,7398,7358,['ausopen'],2018,1,4,13,2018-01-25 13:42:33
11,8163,8152,['ausopen'],2018,1,4,12,2018-01-25 12:49:08
107,12491,12384,['ausopen'],2018,1,4,11,2018-01-25 11:38:44
7,3659,3652,"['ausopen', 'mastercardau']",2018,1,4,10,2018-01-25 10:35:11
169,17004,16835,['ausopen'],2018,1,4,9,2018-01-25 09:32:12
22,12856,12834,['ausopen'],2018,1,4,8,2018-01-25 08:35:51
90,11214,11124,['beheardberecognised'],2018,1,4,6,2018-01-25 06:51:45
104,15150,15046,['ausopen'],2018,1,4,6,2018-01-25 06:13:20
12,4872,4860,['KiaTennis'],2018,1,4,5,2018-01-25 05:36:49
6,2424,2418,['AOLiveStage'],2018,1,4,5,2018-01-25 05:15:57
44,10139,10095,['ausopen'],2018,1,4,4,2018-01-25 04:31:00
53,7250,7197,['ausopen'],2018,1,4,3,2018-01-25 03:45:28
5,2369,2364,"['Yonex', 'AusOpen', 'YonexTensionWins']",2018,1,4,3,2018-01-25 03:14:17
227,20579,20352,['ausopen'],2018,1,4,2,2018-01-25 02:51:53
158,14142,13984,['ausopen'],2018,1,4,1,2018-01-25 01:46:51
71,11274,11203,['ausopen'],2018,1,4,1,2018-01-25 01:00:16
20,4498,4478,"['ClubAperol', 'SPRITZLIFE', 'summerinaglass', 'AperolSpritzAU', 'AperolSpritz']",2018,1,4,0,2018-01-25 00:38:30
63,13841,13778,['ausopen'],2018,1,4,0,2018-01-25 00:10:58
0,1956,1956,"['ccracquetclub', 'AusOpen', 'CanadianClub']",2018,1,3,23,2018-01-24 23:31:26
1,2206,2205,"['AOLiveStage', 'AusOpen']",2018,1,3,23,2018-01-24 23:18:58
43,8642,8599,['AusOpen'],2018,1,3,23,2018-01-24 23:13:59
9,7118,7109,['ausopen'],2018,1,3,23,2018-01-24 23:10:54
9,4501,4492,['AusOpen'],2018,1,3,21,2018-01-24 21:46:45
15,6234,6219,['ausopen'],2018,1,3,21,2018-01-24 21:14:37
8,4314,4306,"['wandervictoria', 'visitmelbourne', 'AusOpen']",2018,1,3,19,2018-01-24 19:02:29
224,17215,16991,['AusOpen'],2018,1,3,18,2018-01-24 18:01:23
16,5360,5344,"['BeAWellBeing', 'Blackmores']",2018,1,3,16,2018-01-24 16:03:49
22,6036,6014,['ausopen'],2018,1,3,13,2018-01-24 13:32:40
189,17211,17022,['ausopen'],2018,1,3,12,2018-01-24 12:33:44
23,8404,8381,['ausopen'],2018,1,3,11,2018-01-24 11:42:38
14,5605,5591,['ausopen'],2018,1,3,10,2018-01-24 10:34:29
9,4340,4331,"['KiaTennis', 'AusOpen']",2018,1,3,9,2018-01-24 09:36:38
280,35968,35688,"['AusOpen', 'FlindersStreetStation']",2018,1,3,8,2018-01-24 08:01:18
13,3941,3928,"['BarillaAO', 'AusOpen', 'MastersOfPasta']",2018,1,3,7,2018-01-24 07:12:44
172,29172,29000,['ausopen'],2018,1,3,6,2018-01-24 06:07:36
69,14724,14655,['ausopen'],2018,1,3,5,2018-01-24 05:38:09
10,2729,2719,"['AOLiveStage', 'AusOpen']",2018,1,3,5,2018-01-24 05:25:57
46,17046,17000,['ausopen'],2018,1,3,4,2018-01-24 04:48:33
21,5181,5160,['beheardberecognised'],2018,1,3,4,2018-01-24 04:14:10
33,9935,9902,['ausopen'],2018,1,3,3,2018-01-24 03:47:14
0,1824,1824,['AusOpen'],2018,1,3,2,2018-01-24 02:43:23
214,16685,16471,['ausopen'],2018,1,3,2,2018-01-24 02:12:39
12,2942,2930,"['AusOpen', 'LavazzaAO']",2018,1,3,1,2018-01-24 01:42:49
34,7847,7813,"['tennis', 'flashbackfriday', 'instasport', 'birthday', 'atpworldtour', 'tennistv', 'atp', 'sport']",2018,4,5,7,2018-04-06 07:55:47
154,13457,13303,"['tbt', 'tennis', 'montecarlo', 'instasport', 'becker', 'throwback', 'atpworldtour', 'tennistv', 'atp', 'sport', 'throwbackthursday']",2018,4,4,7,2018-04-05 07:40:46
9,4499,4490,"['tennis', 'montecarlo', 'wednesday', 'instasport', 'goffin', 'atpworldtour', 'tennistv', 'atp', 'sport', 'humpday', 'joy', 'emotions']",2018,4,3,12,2018-04-04 12:22:09
83,13180,13097,"['tennis', 'miami', 'nadal', 'instasport', 'federer', 'otd', 'throwback', 'atpworldtour', 'tennistv', 'OnThisDay', 'atp', 'sport', 'miamiopen']",2018,4,2,13,2018-04-03 13:55:20
128,16697,16569,"['tennis', 'miami', 'hotshots', 'instasport', 'bestshots', 'atpworldtour', 'tennistv', 'atp', 'sport', 'miamiopen']",2018,4,2,8,2018-04-03 08:04:14
55,11210,11155,"['tennis', 'miami', 'hotshots', 'instasport', 'bestshots', 'atpworldtour', 'tennistv', 'atp', 'sport', 'miamiopen']",2018,4,2,6,2018-04-03 06:31:09
31,8391,8360,"['tennis', 'miami', 'slowmotion', 'champion', 'winning', 'atpworldtour', 'tennistv', 'johnisner', 'motivationmonday', 'atp', 'slowmo', 'miamiopen', 'mondaymotivation', 'isner']",2018,4,1,18,2018-04-02 18:32:58
63,10589,10526,"['tennis', 'miami', 'sports', 'tennisv', 'sport', 'miamiopen']",2018,4,1,12,2018-04-02 12:33:05
147,12768,12621,"['tennis', 'numberone', 'no1', 'nadal', 'instasport', 'atpworldtour', 'tennistv', 'atp', 'sport']",2018,4,1,9,2018-04-02 09:00:01
27,6382,6355,"['tennis', 'miami', 'crandonpark', 'instasport', 'keybiscayne', 'sports', 'tennistv', 'miamiopen']",2018,4,0,20,2018-04-01 20:00:03
166,19040,18874,"['tennis', 'miami', '305', 'instasport', 'champion', 'zverev', 'speech', 'atpworldtour', 'tennistv', 'johnisner', 'atp', 'instagood', 'respect', 'miamiopen']",2018,4,0,17,2018-04-01 17:21:45
44,8305,8261,"['tennis', 'miami', 'winning', 'slomo', 'instaslow', 'atpworldtour', 'tennistv', 'johnisner', 'atp', 'slowmo', 'miamiopen', 'celly', 'celebration', 'isner']",2018,4,0,16,2018-04-01 16:45:08
80,14560,14480,"['tennis', '305', 'miami', 'instasport', 'champion', 'atpworldtour', 'tennistv', 'johnisner', 'atp', 'instagood', 'miamiopen', 'isner']",2018,4,0,15,2018-04-01 15:55:09
144,18278,18134,"['tennis', 'miami', 'miamiopen', 'instasport', 'champion', 'winning', 'tennistv', 'johnisner', 'sports', 'usa', 'isner']",2018,4,0,15,2018-04-01 15:39:55
125,17692,17567,"['tennis', '305', 'hotshot', 'instasport', 'zverev', 'Miami', 'atpworldtour', 'tennistv', 'miamiopen', 'isner']",2018,4,0,15,2018-04-01 15:14:18
24,6277,6253,"['tennis', 'miami', 'zverev', 'isner', 'atpworldtour', 'tennistv', 'atp', 'livestream', 'sports', 'miamiopen', 'live', 'livesports']",2018,4,0,13,2018-04-01 13:16:47
139,10414,10275,"['tennis', 'miami', 'zverev', 'atpworldtour', 'tennistv', 'sports', 'atp', 'livestream', 'sport', 'miamiopen', 'isner']",2018,4,0,9,2018-04-01 09:42:26
86,5187,5101,"['tennis', 'miami', 'zverev', 'atpworldtour', 'tennistv', 'sports', 'atp', 'livestream', 'sport', 'miamiopen', 'live', 'isner']",2018,3,6,18,2018-03-31 18:32:13
37,11204,11167,"['tennis', 'miami', 'bryanbrothers', 'doubles', 'winning', 'bryans', 'tennistv', 'sports', 'miamiopen', 'champions']",2018,3,6,17,2018-03-31 17:40:24
55,11691,11636,"['tennis', 'miami', 'instasport', 'zverev', 'saschazverev', 'tennistv', 'atp', 'miamitennis', 'miamiopen']",2018,3,5,21,2018-03-30 21:36:21
94,8746,8652,"['tennis', 'miami', 'instasport', 'zverev', 'atpworldtour', 'sports', 'tennistv', 'atp', 'saschazverev', 'sport', 'miamiopen']",2018,3,5,18,2018-03-30 18:37:23
96,12384,12288,"['tennis', 'miami', 'highlights', 'atpworldtour', 'tennistv', 'johnisner', 'atp', 'miamiopen', 'isner']",2018,3,5,18,2018-03-30 18:04:03
49,8634,8585,"['tennis', 'miami', 'ole', 'delpotro', 'instasport', 'atpworldtour', 'tennistv', 'atp', 'delpo', 'fifteenlove', 'miamiopen']",2018,3,5,15,2018-03-30 15:26:42
65,11561,11496,"['tennis', 'toogood', 'miami', 'instasport', 'atpworldtour', 'tennistv', 'atp', 'johnisner', 'delpo', 'instagood', 'miamiopen', 'isner']",2018,3,5,15,2018-03-30 15:00:37
130,13555,13425,"['tennis', 'miami', 'instasport', 'atpworldtour', 'tennistv', 'atp', 'johnisner', 'miamiopen', 'isner']",2018,3,5,14,2018-03-30 14:20:15
7,7478,7471,"['tennis', 'miami', 'views', 'fridayfeeling', 'keybiscayne', 'tennistv', 'delpo', 'viewgoals', 'sports', 'instagood', 'sport', 'miamiopen']",2018,3,5,13,2018-03-30 13:42:42
50,12132,12082,"['tennis', 'miami', '305', 'instasport', 'atpworldtour', 'tennistv', 'atp', 'miamiopen']",2018,3,4,23,2018-03-29 23:08:47
25,9462,9437,"['tennis', 'coric', 'miami', '305', 'bornacoric', 'instasport', 'atpworldtour', 'tennistv', 'atp', 'battle', 'miamiopen']",2018,3,4,22,2018-03-29 22:22:30
28,6521,6493,"['tennis', 'miami', '305', 'instasport', 'pablocarrenobusta', 'atpworldtour', 'tennistv', 'atp', 'miamiopen']",2018,3,4,18,2018-03-29 18:51:45
128,13120,12992,"['tennis', 'miami', 'hotshot', 'instasport', 'atpworldtour', 'tennistv', 'sports', 'atp', 'miamiopen', 'carrenobusta']",2018,3,4,18,2018-03-29 18:19:05
97,11918,11821,"['tennis', 'miami', 'instasport', 'sports', 'tennistv', 'funny', 'miamiopen']",2018,3,4,16,2018-03-29 16:49:00
69,6460,6391,"['tennis', 'miami', 'bryanbrothers', 'iconic', 'instasport', 'bryans', 'tennistv', 'sports', 'miamiopen', 'celly', 'celebration']",2018,3,4,13,2018-03-29 13:12:33
146,16854,16708,"['tennis', 'miami', 'florida', 'delpotro', 'instasport', 'atpworldtour', 'tennistv', 'delpo', 'funny', 'atp', 'sport']",2018,3,4,7,2018-03-29 07:12:39
46,9297,9251,"['tennis', 'miami', 'crowd', 'atmosphere', 'delpotro', 'instasport', 'tennistv', 'delpo', 'sports', 'miamiopen']",2018,3,4,1,2018-03-29 01:43:13
82,14423,14341,"['tennis', '305', 'miami', 'delpotro', 'instasport', 'MiamiOpen', 'oleoleole', 'atpworldtour', 'tennistv', 'atp', 'delpo', 'raonic']",2018,3,4,1,2018-03-29 01:06:09
195,16313,16118,"['tennis', 'miami', 'hotshot', 'delpotro', 'instasport', 'atpworldtour', 'tennistv', 'delpo', 'atp', 'miamiopen', 'fire']",2018,3,3,22,2018-03-28 22:13:24
10,4794,4784,"['tennis', '305', 'miami', 'instasport', 'steviej', 'stevejohnson', 'tennistv', 'atp', 'atpworldtour', 'instagood', 'miamiopen', 'lol']",2018,3,3,19,2018-03-28 19:05:50
133,13922,13789,"['tennis', 'miami', 'nadal', 'federer', 'instasport', 'otd', 'throwback', 'onthisday', 'tennistv', 'fedal', 'flashback', 'miamiopen']",2018,3,3,18,2018-03-28 18:02:41
17,5787,5770,"['tennis', 'miamiopen', 'HumpDay', 'instasport', 'tennistv', 'humpday']",2018,3,3,14,2018-03-28 14:38:04
106,16204,16098,"['tennis', 'coric', 'miami', 'bornacoric', 'shapovalov', 'instasport', 'atpworldtour', 'tennistv', 'sports', 'atp', 'miamiopen']",2018,3,3,13,2018-03-28 13:00:51
88,15382,15294,"['tennis', 'hotshot', 'shanghai', 'instasport', 'atpworldtour', 'tennistv', 'atp', 'sport', 'stantheman', 'wawrinka']",2018,3,3,7,2018-03-28 07:55:04
47,12334,12287,"['tennis', 'miami', 'florida', 'instasport', 'zverev', 'atpworldtour', 'tennistv', 'atp', 'sport', 'kyrgios']",2018,3,3,7,2018-03-28 07:07:10
132,7804,7672,"['tennis', 'miami', 'instasport', 'atpworldtour', 'tennistv', 'atp', 'sports', 'miamiopen']",2018,3,2,23,2018-03-27 23:22:11
47,11992,11945,"['tennis', 'miami', 'instasport', 'atpworldtour', 'sports', 'tennistv', 'atp', 'sport', 'miamiopen']",2018,3,2,23,2018-03-27 23:18:36
242,16567,16325,"['tennis', 'miami', 'instasport', 'zverev', 'atpworldtour', 'sports', 'tennistv', 'atp', 'funny', 'miamiopen']",2018,3,2,22,2018-03-27 22:34:31
26,5737,5711,"['tennis', 'coric', 'miami', 'bornacoric', 'instasport', 'winning', 'atpworldtour', 'sports', 'tennistv', 'atp', 'miamiopen']",2018,3,2,19,2018-03-27 19:33:44
103,10444,10341,"['tennis', 'miami', 'hype', 'instasport', 'saschazverev', 'nickkyrgios', 'tennistv', 'sports', 'miamiopen', 'kyrgios']",2018,3,2,16,2018-03-27 16:59:48
47,9534,9487,"['tennis', '305', 'miami', 'tiafoe', 'bigfoe', 'atpworldtour', 'tennistv', 'atp', 'miamiopen']",2018,3,2,16,2018-03-27 16:24:03
548,11947,11399,"['tennis', 'racketsmash', 'miami', 'angry', 'instasport', 'redmist', 'youzhny', 'tennistv', 'sports', 'sport', 'miamiopen']",2018,3,2,11,2018-03-27 11:02:10
11,7323,7312,"['tennis', 'miami', '305', 'Kevinanderson', 'instasport', 'atpworldtour', 'tennistv', 'atp', 'miamiopen']",2018,3,1,22,2018-03-26 22:35:39
275,12285,12010,"['tennis', 'hype', 'instasport', 'zverev', 'saschazverev', 'tennistv', 'sports', 'nickkyrgios', 'atp', 'atpworldtour', 'sport', 'kyrgios']",2018,3,1,21,2018-03-26 21:58:21
58,12042,11984,"['tennis', 'miami', 'hotshot', 'usa', 'instasport', 'highlights', 'atpworldtour', 'tennistv', 'atp', 'sports', 'miamiopen', 'canada']",2018,3,1,21,2018-03-26 21:24:32
387,23868,23481,"['tennis', 'miami', 'cute', 'zverev', 'saschazverev', 'tennistv', 'atpworldtour', 'atp', 'miamiopen']",2018,3,1,19,2018-03-26 19:50:46
105,9848,9743,"['tennis', 'shapovalov', 'tenniscanada', 'atpworldtour', 'tennistv', 'atp', 'miamiopen', 'gocanadago']",2018,3,1,19,2018-03-26 19:40:49
187,15381,15194,"['tennis', 'miami', 'cute', 'instasport', 'atpworldtour', 'nickkyrgios', 'tennistv', 'atp', 'sports', 'miamiopen', 'kyrgios']",2018,3,1,16,2018-03-26 16:34:59
14,5234,5220,"['tennis', '305', 'celtics', 'instasport', 'nba', 'atpworldtour', 'tennistv', 'atp', 'nickkyrgios', 'kyrgios', 'miamiopen', 'msdstrong']",2018,3,1,10,2018-03-26 10:14:26
337,11301,10964,"['tennis', 'miami', 'mondays', 'instasport', 'monday', 'throwback', 'atpworldtour', 'tennistv', 'atp', 'sports', 'mondaymood', 'miamiopen']",2018,3,1,9,2018-03-26 09:36:32
76,13634,13558,"['tennis', 'crandonpark', 'miamiopen2018', 'instasport', 'ftw', 'backspin', 'atpworldtour', 'tennistv', 'atp', 'milosraonic', 'raonic']",2018,3,1,0,2018-03-26 00:28:35
14,4558,4544,"['tennis', 'crandonpark', 'instasport', 'atpworldtour', 'tennistv', 'atp', 'miamiopen']",2018,3,0,20,2018-03-25 20:06:50
41,9060,9019,"['tennis', 'trickshot', 'miami', 'hotshot', 'nishikori', 'sports', 'tennistv', 'sport', 'miamiopen']",2018,3,0,17,2018-03-25 17:54:12
554,33200,32646,"['tennis', 'instasport', 'commitment', 'tenniscanada', 'atpworldtour', 'tennistv', 'atp', 'vasekpospisil', 'miamiopen', 'pospisil']",2018,3,0,17,2018-03-25 17:16:02
21,6446,6425,"['tennis', 'miami', 'delpotro', 'instasport', 'fans', 'tennistv', 'delpo', 'sports', 'miamiopen', 'sundayfunday']",2018,3,0,12,2018-03-25 12:50:15
8,3079,3071,"['tennis', 'miami', 'views', 'florida', 'instasport', 'scenic', 'atpworldtour', 'tennistv', 'instagood', 'sports', 'atp', 'miamiopen']",2018,3,0,11,2018-03-25 11:13:00
157,9929,9772,"['tennis', 'miami', 'delpotro', 'instasport', 'nishikori', 'atpworldtour', 'tennistv', 'delpo', 'atp', 'sports', 'miamiopen']",2018,3,0,9,2018-03-25 09:23:42
97,13024,12927,"['tennis', 'miami', 'instasport', 'atpworldtour', 'nickkyrgios', 'tennistv', 'atp', 'sports', 'miamiopen', 'tweener', 'kyrgios']",2018,3,6,21,2018-03-24 21:50:55
129,10906,10777,"['tennis', 'miami', '305', 'aussiesofinstagram', 'kokkinakis', 'federer', 'instasport', 'atpworldtour', 'tennistv', 'atp', 'instagood', 'miamiopen']",2018,3,6,18,2018-03-24 18:52:50
370,19344,18974,"['tennis', 'miami', 'hotshot', 'federer', 'instasport', 'atpworldtour', 'tennistv', 'rogerfederer', 'atp', 'sports', 'miamiopen']",2018,3,6,17,2018-03-24 17:19:24
99,14409,14310,"['tennis', 'miami', 'shapovalov', 'instasport', 'sportshighlights', 'highlights', 'atpworldtour', 'tennistv', 'atp', 'sports', 'shapo', 'miamiopen']",2018,3,6,13,2018-03-24 13:53:38
79,10527,10448,"['tennis', 'miami', 'federer', 'instasport', 'atpworldtour', 'tennistv', 'rogerfederer', 'atp', 'sports', 'miamiopen']",2018,3,6,12,2018-03-24 12:16:00
68,10184,10116,"['tennis', 'miami', 'hotshot', 'highlights', 'atpworldtour', 'tennistv', 'atp', 'nickkyrgios', 'miamiopen', 'kyrgios']",2018,3,6,8,2018-03-24 08:58:52
418,22051,21633,"['tennis', 'miami', 'instasport', 'robinhaase', 'atpworldtour', 'sports', 'tennistv', 'atp', 'miamiopen']",2018,3,5,23,2018-03-23 23:25:11
39,8337,8298,"['tennis', 'miami', 'happy', 'delpotro', 'winning', 'tennistv', 'delpo', 'sports', 'miamiopen', 'smile']",2018,3,5,23,2018-03-23 23:05:55
278,17413,17135,"['tennis', 'miami', 'hotshot', 'delpotro', 'instasport', 'atpworldtour', 'tennistv', 'delpo', 'sports', 'atp', 'sport', 'miamiopen']",2018,3,5,22,2018-03-23 22:01:44
118,9410,9292,"['tennis', 'puppy', 'instasport', 'zverev', 'nationalpuppyday', 'puppiesofinstagram', 'tennistv', 'sports', 'atp', 'atpworldtour', 'dog']",2018,3,5,19,2018-03-23 19:41:51
151,11215,11064,"['tennis', 'miami', 'instasport', 'atpworldtour', 'tennistv', 'sports', 'atp', 'sport', 'miamiopen', 'benoitpaire', 'paire']",2018,3,5,17,2018-03-23 17:20:23
39,7687,7648,"['tennis', '305', 'crandonpark', 'instasport', 'tennistv', 'milosraonic', 'raonic', 'miamiopen']",2018,3,5,16,2018-03-23 16:23:29
15,4703,4688,"['tennis', 'instachile', 'miami', 'instasport', 'argentina', 'schwartzman', 'tennistv', 'sports', 'chile', 'miamiopen']",2018,3,5,15,2018-03-23 15:42:32
213,12384,12171,"['tennis', 'miami', 'delpotro', 'instasport', 'cute', 'atpworldtour', 'tennistv', 'delpo', 'sports', 'atp', 'miamiopen']",2018,3,5,14,2018-03-23 14:34:53
74,10958,10884,"['tennis', 'miami', 'atpworldtour', 'tennistv', 'sports', 'atp', 'sport', 'miamiopen', 'paire']",2018,3,5,11,2018-03-23 11:37:15
158,10556,10398,"['tennis', 'fail', 'instasport', 'tennistv', 'sports', 'funny', 'miamiopen']",2018,3,4,22,2018-03-22 22:43:43
21,8491,8470,"['tennis', 'miami', 'instasport', 'djokovic', 'atpworldtour', 'tennistv', 'atp', 'novakdjokovic', 'sport', 'miamiopen']",2018,3,4,19,2018-03-22 19:55:59
66,7648,7582,"['tennis', 'instasport', 'atpworldtour', 'nickkyrgios', 'tennistv', 'sports', 'atp', 'sport', 'kyrgios']",2018,3,4,16,2018-03-22 16:45:02
158,8661,8503,"['tennis', 'miami', 'fail', 'instasport', 'sports', 'tennistv', 'funny', 'sport', 'miamiopen']",2018,3,4,14,2018-03-22 14:43:14
9,5704,5695,"['tennis', 'instasport', 'kyleedmund', 'serve', 'tennistv', 'atp', 'atpworldtour', 'sequence', 'miamiopen']",2018,3,4,12,2018-03-22 12:38:41
216,13764,13548,"['tennis', 'miami', 'shapovalov', 'hotshot', 'instasport', 'atpworldtour', 'tennistv', 'sports', 'atp', 'sport', 'miamiopen']",2018,3,4,7,2018-03-22 07:58:39
28,5938,5910,"['tennis', 'miami', 'instasport', 'atpworldtour', 'tennistv', 'atp', 'sports', 'sport', 'miamiopen']",2018,3,3,21,2018-03-21 21:50:12
251,20654,20403,"['tennis', 'miami', 'instasport', 'MiamiOpen', 'atpworldtour', 'tennistv', 'sports', 'atp', 'miamiopen']",2018,3,3,21,2018-03-21 21:24:39
179,13195,13016,"['tennis', 'miami', 'hotshot', 'instasport', 'atpworldtour', 'tennistv', 'sports', 'atp', 'miamiopen', 'benoitpaire', 'paire']",2018,3,3,20,2018-03-21 20:46:21
38,9011,8973,"['tennis', 'miami', 'instasport', 'lucky', 'atpworldtour', 'sports', 'tennistv', 'atp', 'funny', 'miamiopen']",2018,3,3,18,2018-03-21 18:12:40
715,18297,17582,"['tennis', 'miami', 'instasport', 'throwback', 'atpworldtour', 'tennistv', 'atp', 'sports', 'sport', 'miamiopen']",2018,3,3,12,2018-03-21 12:49:51
80,14895,14815,"['tennis', 'bnppo18', 'instasport', 'indianwells', 'atpworldtour', 'tennistv', 'sports', 'atp', 'sport']",2018,3,3,8,2018-03-21 08:57:57
39,8149,8110,"['tennis', 'miami', 'federer', 'slowmotion', 'slowmo', 'slomo', 'atpworldtour', 'tennistv', 'sports', 'atp', 'rogerfederer', 'sport', 'miamiopen']",2018,3,2,18,2018-03-20 18:09:09
142,10890,10748,"['tennis', 'miami', 'instasport', 'throwback', 'atpworldtour', 'tennistv', 'atp', 'andymurray', 'novakdjokovic', 'sports', 'miamiopen']",2018,3,2,12,2018-03-20 12:14:46
37,6586,6549,"['tennis', 'miami', 'instasport', 'atpworldtour', 'tennistv', 'TFW', 'atp', 'sports', 'sport', 'miamiopen', 'mondaymotivation']",2018,3,1,17,2018-03-19 17:57:18
41,6222,6181,"['tennis', 'bnppo18', 'delpotro', 'indianwells', 'tennistv', 'delpo', 'sport']",2018,3,1,10,2018-03-19 10:01:45
53,15527,15474,"['tennis', 'bnppo18', 'MondayMotivation', 'delpotro', 'instasport', 'monday', 'atpworldtour', 'tennistv', 'delpo', 'sports', 'atp', 'motivationmonday', 'indianwells', 'mondaymotivation']",2018,3,1,5,2018-03-19 05:37:08
47,9453,9406,"['tennis', 'bnppo18', 'delpotro', 'champion', 'atpworldtour', 'tennistv', 'delpo', 'instagood']",2018,3,0,22,2018-03-18 22:26:06
248,24702,24454,"['tennis', 'bnppo18', 'delpotro', 'federer', 'instasport', 'atpworldtour', 'tennistv', 'rogerfederer', 'delpo', 'instagood']",2018,3,0,21,2018-03-18 21:51:47
174,18814,18640,"['tennis', 'matchpoint', 'delpotro', 'instasport', 'champion', 'indianwells', 'atpworldtour', 'tennistv', 'atp', 'sport', 'bnpparibasopen', 'celebration']",2018,3,0,19,2018-03-18 19:12:17
222,19425,19203,"['tennis', 'bnppo18', 'instasport', 'indianwells', 'atpworldtour', 'tennistv', 'atp', 'sport', 'bnpparibasopen']",2018,3,0,18,2018-03-18 18:54:43
220,21573,21353,"['tennis', 'bnppo18', 'delpotro', 'instasport', 'federer', 'atpworldtour', 'tennistv', 'atp', 'sport', 'bnpparibasopen']",2018,3,0,17,2018-03-18 17:05:10
9,4422,4413,"['tennis', 'bnppo18', 'instasport', 'sport', 'atpworldtour', 'tennistv', 'atp', 'indianwells', 'bnpparibasopen', 'final']",2018,3,0,15,2018-03-18 15:17:50
34,7577,7543,"['tennis', 'Rogerfederer', 'bnppo18', 'delpotro', 'federer', 'instasport', 'atpworldtour', 'tennistv', 'atp', 'delpo', 'instagood', 'indianwells', 'bnpparibasopen']",2018,3,0,12,2018-03-18 12:59:34
88,16397,16309,"['tennis', 'bnppo18', 'instasport', 'federer', 'indianwells', 'atpworldtour', 'tennistv', 'delpo', 'atp', 'sport', 'bnpparibasopen']",2018,3,0,12,2018-03-18 12:19:33
114,12311,12197,"['tennis', 'hotshot', 'instasport', 'doubles', 'BNPPPO18', 'indianwells', 'atpworldtour', 'tennistv', 'atp', 'sport', 'bnpparibasopen']",2018,3,6,21,2018-03-17 21:39:00
228,13606,13378,"['tennis', 'bnppo18', 'TennisParadise', 'federer', 'delpotro', 'instasport', 'tennistv', 'rogerfederer', 'delpo', 'indianwells', 'juanmartindelpotro']",2018,3,6,19,2018-03-17 19:35:53
42,9836,9794,"['tennis', 'instasport', 'bnpparibasopen', 'atpworldtour', 'tennistv', 'atp', 'indianwells', 'BNPPO18', 'sport']",2018,3,6,18,2018-03-17 18:26:20
65,12544,12479,"['tennis', 'bnppo18', 'instasport', 'indianwells', 'atpworldtour', 'tennistv', 'atp', 'sport', 'bnpparibasopen']",2018,3,6,16,2018-03-17 16:43:41
272,21996,21724,"['tennis', 'coric', 'bnppo18', 'instasport', 'federer', 'indianwells', 'atpworldtour', 'tennistv', 'atp', 'sport', 'bnpparibasopen']",2018,3,6,16,2018-03-17 16:21:36
20,4354,4334,"['tennis', 'bnppo18', 'instasport', 'indianwells', 'atpworldtour', 'tennistv', 'atp', 'sport', 'bnpparibasopen']",2018,3,6,13,2018-03-17 13:39:12
220,14228,14008,"['tennis', 'coric', 'delpotro', 'instasport', 'federer', 'indianwells', 'atpworldtour', 'tennistv', 'atp', 'raonic', 'sport', 'BNPPO18', 'bnpparibasopen', 'semifinals']",2018,3,6,11,2018-03-17 11:37:04
232,17541,17309,"['tennis', 'miami', 'instasport', 'doubles', 'atpworldtour', 'sports', 'tennistv', 'atp', 'miamiopen']",2018,3,6,5,2018-03-17 05:03:24
13,9058,9045,"['tennis', 'bnppo18', 'instasport', 'indianwells', 'tennistv', 'delpo', 'sport', 'bnpparibasopen']",2018,3,5,21,2018-03-16 21:48:10
18,7712,7694,"['tennis', 'bnppo18', 'instasport', 'indianwells', 'atpworldtour', 'tennistv', 'delpo', 'atp', 'sport', 'bnpparibasopen']",2018,3,5,19,2018-03-16 19:47:55
15,5912,5897,"['tennis', 'bnppo18', 'instasport', 'atpworldtour', 'tennistv', 'atp', 'milosraonic', 'raonic', 'bnpparibasopen']",2018,3,5,19,2018-03-16 19:01:41
47,6119,6072,"['tennis', 'bnppo18', 'forehand', 'instasport', 'slomo', 'atpworldtour', 'tennistv', 'delpo', 'atp', 'california', 'sport', 'bnpparibasopen']",2018,3,5,16,2018-03-16 16:14:35
34,11526,11492,"['tennis', 'bnppo18', 'indianwells', 'atpworldtour', 'tennistv', 'atp', 'tommyhaas', 'haas', 'bnpparibasopen']",2018,3,5,15,2018-03-16 15:32:41
283,19825,19542,"['tennis', 'backhand', 'bnppo18', 'instasport', 'federer', 'indianwells', 'tennistv', 'rogerfederer', 'sport', 'bnpparibasopen']",2018,3,5,0,2018-03-16 00:41:22
115,9604,9489,"['tennis', 'bnppo18', 'chung', 'instasport', 'federer', 'indianwells', 'atpworldtour', 'tennistv', 'atp', 'sport']",2018,3,4,20,2018-03-15 20:42:57
20,8605,8585,"['tennis', 'coric', 'bnppo18', 'instasport', 'indianwells', 'tennistv', 'sport', 'bnpparibasopen']",2018,3,4,19,2018-03-15 19:24:01
87,5064,4977,"['tennis', 'tbt', 'andreagassi', 'miami', 'instasport', 'MiamiOpen', 'djokovic', 'tennistv', 'novakdjokovic', 'agassi', 'sports', 'miamiopen', 'throwbackthursday']",2018,3,4,11,2018-03-15 11:32:33
54,9989,9935,"['tennis', 'bnppo18', 'instasport', 'doubles', 'atpworldtour', 'tennistv', 'atp', 'sports', 'indianwells', 'sport']",2018,3,4,10,2018-03-15 10:50:25
198,21434,21236,"['tennis', 'instasport', 'federer', 'indianwells', 'tennistv', 'sport', 'BNPPO18', 'bnpparibasopen']",2018,3,4,0,2018-03-15 00:14:19
60,12303,12243,"['tennis', 'instasports', 'bnppo18', 'hotshot', 'lopez', 'atpworldtour', 'tennistv', 'atp', 'instagood', 'felicianolopez', 'indianwells']",2018,3,3,23,2018-03-14 23:03:25
54,13143,13089,"['tennis', 'instasport', 'indianwells', 'atpworldtour', 'tennistv', 'atp', 'sport', 'BNPPO18']",2018,3,3,21,2018-03-14 21:00:03
63,10042,9979,"['tennis', 'chung', 'atpworldtour', 'tennistv', 'atp', 'indianwells', 'BNPPO18', 'bnpparibasopen']",2018,3,3,15,2018-03-14 15:54:53
30,7657,7627,"['tennis', 'views', 'bnppo18', 'TennisParadise', 'instasport', 'atpworldtour', 'tennistv', 'sports', 'atp', 'instagood', 'california', 'indianwells', 'cali', 'sport']",2018,3,3,13,2018-03-14 13:37:59
211,13741,13530,"['tennis', 'miami', 'instasport', 'MiamiOpen', 'djokovic', 'atpworldtour', 'tennistv', 'sports', 'novakdjokovic', 'atp', 'sport']",2018,3,3,12,2018-03-14 12:40:28
40,4953,4913,"['tennis', 'bnppo18', 'indianwells', 'atpworldtour', 'tennistv', 'sports', 'atp', 'livestream', 'sport', 'live']",2018,3,3,10,2018-03-14 10:17:20
116,16251,16135,"['tennis', 'bnppo18', 'indianwells', 'atpworldtour', 'tennistv', 'atp', 'sport']",2018,3,2,21,2018-03-13 21:40:44
28,6077,6049,"['tennis', 'pablocuevas', 'bnppo18', 'instasport', 'atpworldtour', 'tennistv', 'sports', 'indianwells', 'cuevas']",2018,3,2,20,2018-03-13 20:22:29
172,11476,11304,"['tennis', 'bnppo18', 'instasport', 'federer', 'atpworldtour', 'tennistv', 'rogerfederer', 'sports', 'atp', 'indianwells']",2018,3,2,13,2018-03-13 13:53:00
13,3590,3577,"['tennis', 'views', 'bnppo18', 'TennisParadise', 'instasport', 'tennistv', 'california', 'cali', 'instagood', 'sports', 'indianwells', 'sport']",2018,3,2,13,2018-03-13 13:05:08
34,8933,8899,"['tennis', 'instasport', 'indianwells', 'fritz', 'tennistv', 'atp', 'atpworldtour', 'sport', 'BNPPO18', 'bnpparibasopen', 'celebration']",2018,3,1,22,2018-03-12 22:23:32
684,24391,23707,"['tennis', 'instasport', 'federer', 'dropshot', 'indianwells', 'tennistv', 'funny', 'sport', 'BNPPO18']",2018,3,1,21,2018-03-12 21:35:36
29,9044,9015,"['tennis', 'hotshot', 'instasport', 'indianwells', 'atpworldtour', 'tennistv', 'atp', 'sport', 'BNPPO18']",2018,3,1,19,2018-03-12 19:54:37
114,14719,14605,"['tennis', 'bnppo18', 'federer', 'atpworldtour', 'tennistv', 'rogerfederer', 'sports', 'atp', 'indianwells']",2018,3,1,18,2018-03-12 18:05:36
127,13245,13118,"['tennis', 'bnppo18', 'monfils', 'atpworldtour', 'tennistv', 'sports', 'atp', 'lamonf', 'indianwells', 'gaelmonfils']",2018,3,1,12,2018-03-12 12:51:59
82,11080,10998,"['tennis', 'bnppo18', 'shock', 'instasport', 'atpworldtour', 'tennistv', 'sports', 'atp', 'indianwells', 'upset']",2018,3,1,10,2018-03-12 10:53:47
53,7365,7312,"['tennis', 'bnppo18', 'monday', 'dimitrov', 'atpworldtour', 'tennistv', 'atp', 'mondaymood', 'indianwells', 'fognini']",2018,3,1,9,2018-03-12 09:32:18
43,9490,9447,"['tennis', 'bnppo18', 'hotshot', 'instasport', 'indianwells', 'atpworldtour', 'tennistv', 'sports', 'atp', 'raonic', 'trickshot']",2018,3,1,2,2018-03-12 02:30:02
43,9891,9848,"['tennis', 'bnppo18', 'instasport', 'indianwells', 'atpworldtour', 'tennistv', 'atp', 'sport']",2018,3,0,21,2018-03-11 21:00:24
72,9202,9130,"['tennis', 'blackpanther', 'instasport', 'indianwells', 'atpworldtour', 'tennistv', 'atp', 'lamonf', 'wakanda', 'sport', 'BNPPO18']",2018,3,0,18,2018-03-11 18:41:59
31,4947,4916,"['tennis', 'nole', 'bnppo18', 'legend', 'champion', 'djokovic', 'atpworldtour', 'tennistv', 'novakdjokovic', 'atp', 'indianwells']",2018,3,0,12,2018-03-11 12:07:31
98,15961,15863,"['tennis', 'bnppo18', 'federer', 'instasport', 'atpworldtour', 'tennistv', 'rogerfederer', 'funny', 'sports', 'atp', 'indianwells']",2018,3,0,6,2018-03-11 06:03:11
414,22557,22143,"['tennis', 'fail', 'instasport', 'atpworldtour', 'tennistv', 'atp', 'funny', 'indianwells', 'BNPPO18', 'sport']",2018,3,6,21,2018-03-10 21:49:41
71,9860,9789,"['tennis', 'trickshot', 'indianwells', 'atpworldtour', 'tennistv', 'atp', 'sport', 'BNPPO18']",2018,3,6,17,2018-03-10 17:02:28
8,4271,4263,"['tennis', 'thiem', 'SuperSaturday', 'federer', 'dimitrov', 'instasport', 'atpworldtour', 'tennistv', 'atp', 'indianwells', 'BNPPO18', 'sport']",2018,3,6,13,2018-03-10 13:36:06
56,12419,12363,"['tennis', 'bnppo18', 'federer', 'instasport', 'atpworldtour', 'tennistv', 'rogerfederer', 'livestream', 'sports', 'atp', 'indianwells', 'live']",2018,3,6,11,2018-03-10 11:17:08
83,14055,13972,"['tennis', 'bnppo18', 'delpotro', 'instasport', 'dimitrov', 'indianwells', 'atpworldtour', 'tennistv', 'sports', 'delpo', 'atp', 'sport']",2018,3,6,9,2018-03-10 09:50:39
15,4164,4149,"['tennis', 'instasport', 'tennistv', 'sports', 'nickkyrgios', 'indianwells', 'BNPPO18', 'kyrgios']",2018,3,6,6,2018-03-10 06:33:30
78,9534,9456,"['tennis', 'bnppo18', 'instasport', 'fridayfeeling', 'atpworldtour', 'tennistv', 'NextGenATP', 'sport', 'bnpparibasopen']",2018,3,5,23,2018-03-09 23:41:23
63,15384,15321,"['tennis', 'bnppo18', 'boxing', 'djokovic', 'atpworldtour', 'tennistv', 'atp', 'sport']",2018,3,5,20,2018-03-09 20:32:36
17,9637,9620,"['indianwells', 'BNPPO18', 'Repost']",2018,3,5,18,2018-03-09 18:30:03
314,17423,17109,"['tennis', 'lamonfstory', 'bnppo18', 'instasport', 'indianwells', 'atpworldtour', 'tennistv', 'atp', 'lamonf', 'sport']",2018,3,5,17,2018-03-09 17:55:43
3,3859,3856,"['tennis', 'atpworldtour', 'tennistv', 'atp', 'indianwells', 'BNPPO18', 'sport', 'sock']",2018,3,5,14,2018-03-09 14:04:24
17,2681,2664,"['tennis', 'dancing', 'dance', 'bnppo18', 'instasport', 'fridayfeeling', 'fridaymood', 'tennistv', 'sports', 'indianwells', 'friday']",2018,3,5,10,2018-03-09 10:22:15
104,9052,8948,"['tennis', 'bnppo18', 'fail', 'instasport', 'tennistv', 'sports', 'funny', 'indianwells']",2018,3,5,8,2018-03-09 08:58:57
59,8451,8392,"['tennis', 'trickshot', 'bnppo18', 'hotshot', 'instasport', 'fridayfeeling', 'tennistv', 'sports', 'paire', 'indianwells', 'tweener']",2018,3,5,6,2018-03-09 06:38:22
133,12845,12712,"['tennis', 'instasport', 'atpworldtour', 'tennistv', 'atp', 'NextGenATP', 'sport', 'BNPPO18', 'bnpparibasopen']",2018,3,5,1,2018-03-09 01:58:04
40,7421,7381,"['tennis', 'bnppo18', 'indianwells', 'atpworldtour', 'tennistv', 'atp', 'sport']",2018,3,4,20,2018-03-08 20:48:06
58,5434,5376,"['tennis', 'bnppo18', 'football', 'atpworldtour', 'tennistv', 'atp', 'indianwells']",2018,3,4,15,2018-03-08 15:29:23
60,9366,9306,"['tbt', 'bnppo18', 'hotshot', 'instasport', 'dimitrov', 'grigordimitrov', 'atpworldtour', 'sports', 'atp', 'indianwells', 'throwbackthursday']",2018,3,4,9,2018-03-08 09:04:40
10,3325,3315,"['tennis', 'bnppo18', 'instasport', 'nishikori', 'atpworldtour', 'tennistv', 'TFW', 'keinishikori', 'atp', 'sports', 'indianwells']",2018,3,4,6,2018-03-08 06:17:08
13,6687,6674,"['tennis', 'zverev', 'atpworldtour', 'tennistv', 'atp', 'indianwells', 'BNPPO18', 'sport']",2018,3,4,0,2018-03-08 00:48:23
12,3201,3189,"['tennis', 'bnppo18', 'instasport', 'indianwells', 'atpworldtour', 'tennistv', 'atp', 'NextGenATP', 'sport', 'BNPPO18']",2018,3,3,21,2018-03-07 21:23:29
80,12671,12591,"['tennis', 'bnppo18', 'delpotro', 'djokovic', 'atpworldtour', 'tennistv', 'delpo', 'sports', 'atp', 'indianwells']",2018,3,3,11,2018-03-07 11:35:47
195,9520,9325,"['tennis', 'bnppo18', 'hype', 'instasport', 'indianwells', 'atpworldtour', 'tennistv', 'sports', 'atp', 'sport']",2018,3,3,8,2018-03-07 08:42:24
56,10354,10298,"['tennis', 'bnppo18', 'federer', 'instasport', 'indianwells', 'atpworldtour', 'tennistv', 'atp', 'sport', 'bnpparibasopen']",2018,3,2,20,2018-03-06 20:29:00
107,13246,13139,"['tennis', 'bnppo18', 'hotshot', 'federer', 'atpworldtour', 'tennistv', 'rogerfederer', 'indianwells']",2018,3,2,16,2018-03-06 16:53:20
63,7119,7056,"['tennis', 'bnppo18', 'monfils', 'instasport', 'indianwells', 'atpworldtour', 'tennistv', 'sports', 'atp', 'sport', 'gaelmonfils']",2018,3,2,9,2018-03-06 09:16:56
67,6921,6854,"['tennis', 'bnppo18', 'surprise', 'dimitrov', 'djokovic', 'atpworldtour', 'tennistv', 'atp', 'funny', 'indianwells']",2018,3,2,6,2018-03-06 06:01:03
61,9013,8952,"['tennis', 'monfils', 'instasport', 'atpworldtour', 'tennistv', 'sports', 'atp', 'epic', 'gaelmonfils']",2018,3,1,13,2018-03-05 13:13:04
378,22133,21755,"['tennis', 'bnppo18', 'nadal', 'instasport', 'rafanadal', 'doubles', 'rafa', 'indianwells', 'throwback', 'tennistv', 'sports', 'sport', 'mondaymotivation']",2018,3,1,11,2018-03-05 11:28:04
76,5994,5918,"['tennis', 'instasport', 'atpworldtour', 'tennistv', 'atp', 'funny', 'sports']",2018,3,1,8,2018-03-05 08:24:53
10,4170,4160,"['tennis', 'bnppo18', 'slowmotion', 'instasport', 'practice', 'nishikori', 'slomo', 'instaslow', 'atpworldtour', 'tennistv', 'atp', 'keinishikori', 'sports', 'indianwells', 'slomotion']",2018,3,1,5,2018-03-05 05:56:33
398,17018,16620,"['tennis', 'chile', 'brasil', 'brazil', 'hotshot', 'instasport', 'atpworldtour', 'tennistv', 'sports', 'atp', 'saopaulo', 'sport', 'cheeky']",2018,3,0,14,2018-03-04 14:59:33
37,7565,7528,"['tennis', 'delpotro', 'instasport', 'atpworldtour', 'tennistv', 'atp', 'delpo', 'acapulco', 'sport', 'mexico']",2018,3,0,10,2018-03-04 10:30:15
21,12278,12257,"['tennis', 'delpotro', 'dubai', 'champion', 'ddftennis', 'winning', 'amt2018', 'tennistv', 'sports', 'delpo', 'acapulco', 'sport']",2018,3,0,7,2018-03-04 07:51:46
24,8236,8212,"['tennis', 'bnppo18', 'hotshot', 'instasport', 'djokovic', 'throwback', 'atpworldtour', 'tennistv', 'atp', 'sports', 'novakdjokovic', 'indianwells']",2018,3,0,6,2018-03-04 06:39:29
45,11459,11414,"['tennis', 'delpotro', 'instasport', 'champion', 'winning', 'amt2018', 'acapulco', 'atpworldtour', 'tennistv', 'delpo', 'atp', 'sports', 'sport', 'mexico']",2018,3,0,0,2018-03-04 00:44:50
205,5501,5296,"['tennis', 'bnppo18', 'instasport', 'indianwells', 'atpworldtour', 'tennistv', 'atp', 'sports', 'sport']",2018,3,6,7,2018-03-03 07:39:49
61,10535,10474,"['tennis', 'bnppo18', 'flashbackfriday', 'fbf', 'fb', 'indianwells', 'atpworldtour', 'tennistv', 'sports', 'atp', 'sport']",2018,3,5,17,2018-03-02 17:45:40
46,9996,9950,"['tennis', 'hotshot', 'monfils', 'fridayfeeling', 'fridaymood', 'tennistv', 'sports', 'sport', 'gaelmonfils']",2018,3,5,13,2018-03-02 13:54:08
80,6967,6887,"['tennis', 'bnppo18', 'hype', 'nadal', 'instasport', 'rafa', 'tennistv', 'sports', 'indianwells', 'pumped', 'sport']",2018,3,4,13,2018-03-01 13:06:43
243,13666,13423,"['tbt', 'tennis', 'instasport', 'amt2018', 'throwback', 'atpworldtour', 'tennistv', 'sports', 'atp', 'acapulco', 'throwbackthursday']",2018,3,4,11,2018-03-01 11:49:40
188,10525,10337,"['tennis', 'hotshot', 'showboat', 'instasport', 'mannarino', 'tennistv', 'atp', 'atpworldtour', 'acapulco', 'sport', 'mexico']",2018,3,4,9,2018-03-01 09:48:11
67,11426,11359,"['tennis', 'coric', 'bornacoric', 'hotshot', 'dubai', 'ddftennis', 'atpworldtour', 'sports', 'tennistv', 'atp', 'sport']",2018,3,4,8,2018-03-01 08:13:11
21,6408,6387,"['tennis', 'delpotro', 'instasport', 'amt2018', 'acapulco', 'atpworldtour', 'tennistv', 'delpo', 'sports', 'atp', 'mexico']",2018,2,3,10,2018-02-28 10:06:44
28,7516,7488,"['tennis', 'shapovalov', 'instasport', 'amt2018', 'acapulco', 'atpworldtour', 'sports', 'tennistv', 'atp', 'funny', 'mexico']",2018,2,3,8,2018-02-28 08:24:33
338,13836,13498,"['tennis', 'dubai', 'ddftennis', 'funnymoment', 'atpworldtour', 'tennistv', 'sports', 'funny', 'atp', 'humpday', 'paire']",2018,2,3,5,2018-02-28 05:57:48
31,6264,6233,"['tennis', 'spongebob', 'nadal', 'instasport', 'rafanadal', 'rafa', 'amt2018', 'atpworldtour', 'tennistv', 'atp', 'sports', 'acapulco', 'sport', 'mexico']",2018,2,2,16,2018-02-27 16:23:04
53,6623,6570,"['tennis', 'jaziri', 'shock', 'instasport', 'dubai', 'ddftennis', 'atpworldtour', 'tennistv', 'sports', 'atp', 'sport', 'upset']",2018,2,2,12,2018-02-27 12:57:53
45,6424,6379,"['thiem', 'views', 'instasport', 'zverev', 'AMT2018', 'atpworldtour', 'tennistv', 'sports', 'atp', 'acapulco', 'instagood', 'sport', 'mexico']",2018,2,2,11,2018-02-27 11:54:15
86,7249,7163,"['tennis', 'nadal', 'shapovalov', 'delpotro', 'instasport', 'rafanadal', 'zverev', 'amt2018', 'nishikori', 'atpworldtour', 'tennistv', 'sports', 'atp', 'acapulco', 'delpo', 'sport', 'mexico']",2018,2,2,11,2018-02-27 11:03:42
60,6539,6479,"['tennis', 'ljubicic', 'nadal', 'instasport', 'federer', 'champion', 'mondaymotivation', 'djokovic', 'winner', 'indianwells', 'tennistv', 'IW18', 'sport', 'BNPPO18', 'bnpparibasopen', 'trophy']",2018,2,1,13,2018-02-26 13:30:09
32,8295,8263,"['tennis', 'diving', 'dubai', 'ddftennis', 'atpworldtour', 'tennistv', 'sports', 'atp', 'sport', 'dive']",2018,2,1,11,2018-02-26 11:23:43
25,11573,11548,"['tennis', 'diegoschwartzman', 'champion', 'winning', 'rioopen2018', 'schwartzman', 'atpworldtour', 'tennistv', 'motivationmonday', 'sports', 'atp', 'sport', 'riodejaneiro', 'mondaymotivation', 'trophy', 'rio']",2018,2,1,7,2018-02-26 07:52:52
60,7585,7525,"['tennis', 'instasport', 'dubai', 'ddftennis', 'atpworldtour', 'nickkyrgios', 'tennistv', 'atp', 'sports', 'sport', 'kyrgios']",2018,2,1,6,2018-02-26 06:51:39
63,10907,10844,"['tennis', 'brazil', 'instasport', 'atpworldtour', 'tennistv', 'atp', 'sport', 'riodejaneiro', 'rio']",2018,2,0,17,2018-02-25 17:13:03
0,837,837,"['communitytennis', 'tennis', 'ReturnTheServe', 'USOpen', 'USOpenArtCourtsxChase', 'whoisfirstservemiami', 'kidstennis', 'instatennis', 'instacool', 'USTAFoundation', 'NJTL']",2018,4,5,9,2018-04-06 09:48:35
14,3953,3939,"['couperogers', 'USOpenSeries', 'throwback', 'tennis', 'montreal', 'capriati', 'wta', 'instatennis', 'tenniscanada', 'navratilova']",2018,4,4,21,2018-04-05 21:56:31
9,4097,4088,"['USOpenSeries', 'yalebowl', 'tennis', 'wta', 'newhaven', 'instatennis', 'ctopen', 'summer', 'yale', 'ctopentennis']",2018,4,4,17,2018-04-05 17:10:15
107,6673,6566,"['USOpen50', 'petesampras', 'throwback', 'tennis', 'tbt', 'USOpen', 'flushingmeadows', 'instatennis', 'atp', 'grandslam', 'legend']",2018,4,4,12,2018-04-05 12:36:05
69,7822,7753,"['tennis', 'thursdaythoughts', 'USOpen', 'motivationalquotes', 'wta', 'instatennis', 'womenwhoinspire', 'angiekerber', 'instaquotes']",2018,4,4,11,2018-04-05 11:03:48
17,6968,6951,"['coronapark', 'queens', 'tennis', 'USOpen', 'instawow', 'madeinqueens', 'flushingmeadows', 'instatennis', 'newyork', 'instaview', 'grandslam']",2018,4,3,21,2018-04-04 21:31:39
48,3279,3231,"['USOpen50', 'tennis', 'USOpen', 'argentina', 'flushingmeadows', 'instatennis', 'memories', 'sabatini', 'history', 'grandslam', 'halloffamer']",2018,4,3,17,2018-04-04 17:59:39
120,8538,8418,"['communitytennis', 'tennis', 'ReturnTheServe', 'USOpen', 'venuswilliams', 'USOpenArtCourtsxChase', 'itsallaboutthekids', 'whoisfirstservemiami', 'kidstennis', 'serenawilliams', 'instatennis', 'NJTL', 'tracyaustin']",2018,4,3,16,2018-04-04 16:31:04
31,6308,6277,"['throwback', 'tennis', 'USOpen', 'carlosmoya', 'instapolaroid', 'gugakuerten', 'flushingmeadows', 'instatennis', 'memories', 'grandslam']",2018,4,3,10,2018-04-04 10:33:45
1,3052,3051,"['USOpenSeries', 'tennis', 'atlanta', 'instavista', 'hotlanta', 'bbtao', 'instatennis', 'atpworldtour', 'summer', 'atp']",2018,4,2,22,2018-04-03 22:50:03
45,9008,8963,"['tennis', 'USOpen', 'tommyhaas', 'instaclassic', 'happy', 'germany', 'flushingmeadows', 'instatennis', 'birthday', 'grandslam']",2018,4,2,19,2018-04-03 19:17:58
67,8127,8060,"['tennis', 'USOpen', 'instawow', 'anaivanovic', 'flushingmeadows', 'instatennis', 'forehand', 'fearhand', 'grandslam', 'serbia']",2018,4,2,16,2018-04-03 16:05:35
6,2011,2005,"['artoftennis', 'streetart', 'communitytennis', 'tennis', 'ReturnTheServe', 'SerenaWilliams', 'USOpenArtCourtsxChase', 'itsallaboutthekids', 'whoisfirstservemiami', 'kidstennis', 'instatennis', 'BillieJeanKing', 'artproject', 'USTAFoundation', 'NJTL', 'artwork', 'VenusWilliams']",2018,4,2,12,2018-04-03 12:00:23
7,3447,3440,"['USOpen50', 'hardcourts', 'throwback', 'tennis', 'USOpen', 'instawow', 'color', 'flushingmeadows', 'instatennis', 'memories', 'grandslam']",2018,4,2,10,2018-04-03 10:25:10
40,5195,5155,"['throwback', 'USOpen50', 'tennis', 'USOpen', 'wta', 'belgium', 'flushingmeadows', 'instatennis', 'champion', 'memories', 'instamemories', 'kimclijsters']",2018,4,1,16,2018-04-02 16:09:41
17,5135,5118,"['throwback', 'USOpenSeries', 'ivanovic', 'tennis', 'mubadalasvc', 'wta', 'california', 'petrova', 'instatennis', 'summer']",2018,4,1,14,2018-04-02 14:27:23
56,10449,10393,"['USOpenSeries', 'tennis', 'instawow', 'nadal', 'atpworldtour', 'instatennis', 'summer', 'atp', 'djokovic', 'cincytennis']",2018,4,1,10,2018-04-02 10:00:10
165,14632,14467,"['sports', 'instasports', 'teamusatennis', 'miamiopen', 'tennis', 'ATPMasters1000', 'instatennis', 'atp', 'johnisner']",2018,4,0,16,2018-04-01 16:14:33
40,7906,7866,"['instanyc', 'USOpen', 'nyny', 'instawow', 'network', 'nyc', 'newyorkcity', 'newyorkviews', 'thebigapple', 'easter', 'sunday']",2018,4,0,11,2018-04-01 11:00:35
60,12600,12540,"['wtapremier', 'ustennis', 'miami', 'tennis', 'USOpen', 'instawow', 'wta', 'instatennis', 'sloanestephens', 'gosloane']",2018,3,6,15,2018-03-31 15:02:41
78,8011,7933,"['throwback', 'tennis', 'womenstennis', 'USOpen', 'wta', 'flushingmeadows', 'instatennis', 'seles', 'graf', 'grandslam']",2018,3,6,11,2018-03-31 11:52:10
15,7288,7273,"['sunset', 'USOpenSeries', 'wsopen', 'tennis', 'instawow', 'winstonsalem', 'atpworldtour', 'instatennis', 'wakeforest', 'atp']",2018,3,5,18,2018-03-30 18:10:37
47,6505,6458,"['tennis', 'womenstennis', 'USOpen', 'wta', 'instasport', 'flushingmeadows', 'instatennis', 'sanchezvicario', 'sabatini', 'grandslam']",2018,3,5,9,2018-03-30 09:32:14
17,4279,4262,"['couperogers', 'USOpenSeries', 'tennis', 'hingis', 'hantuchova', 'montreal', 'wta', 'instatennis', 'tenniscanada', 'rogerscup']",2018,3,4,21,2018-03-29 21:07:57
97,8963,8866,"['tennis', 'USOpen', 'chileno', 'instasport', 'cnnchile', 'marcelorios', 'atpworldtour', 'instatennis', 'chinorios', 'atp', 'chile', 'grandslam']",2018,3,4,16,2018-03-29 16:57:20
40,8748,8708,"['miami', 'USOpenSeries', 'tennis', 'womenstennis', 'instawow', 'wta', 'instasport', 'instatennis', 'sloanestephens', 'keybiscayne', 'tennispro']",2018,3,4,15,2018-03-29 15:37:25
31,6920,6889,"['instabirthday', 'juanmonaco', 'tennis', 'USOpen', 'picomonaco', 'argentina', 'happy', 'birthday', 'instatennis', 'grandslam']",2018,3,4,12,2018-03-29 12:15:39
32,6864,6832,"['instabirthday', 'tennis', 'womenstennis', 'USOpen', 'wta', 'nyc', 'happy', 'flushingmeadows', 'birthday', 'jennifercapriati']",2018,3,4,10,2018-03-29 10:19:29
334,22966,22632,"['instasports', 'miami', 'tennis', 'USOpen', 'delpo', 'juanmartindelpotro', 'instatennis', 'delpotro', 'atp', 'protennis']",2018,3,4,0,2018-03-29 00:14:00
25,6677,6652,"['instaviews', 'queens', 'tennis', 'nyc', 'madeinqueens', 'flushingmeadows', 'instatennis', 'newyork', 'grandslam']",2018,3,3,22,2018-03-28 22:25:55
61,8827,8766,"['instasports', 'miami', 'tennis', 'USOpen', 'instawow', 'wta', 'uva', 'daniellecollins', 'instatennis', 'protennis']",2018,3,3,20,2018-03-28 20:45:58
92,9553,9461,"['tennis', 'USOpen', 'happy', 'instasport', 'stantheman', 'instatennis', 'birthday', 'champion', 'wawrinka', 'grandslam']",2018,3,3,13,2018-03-28 13:09:06
8,2693,2685,"['instasports', 'USOpen50', 'davenport', 'tennis', 'USOpen', 'wta', 'instatennis', 'lindsaydavenport', 'womenwhoinspire', 'grandslam']",2018,3,3,11,2018-03-28 11:09:46
8,4752,4744,"['USOpenSeries', 'throwback', 'tennis', 'tiafoe', 'atlanta', 'hotlanta', 'bbtao', 'instatennis', 'atpworldtour', 'atp']",2018,3,2,19,2018-03-27 19:35:58
57,5281,5224,"['USOpen50', 'tennis', 'USOpen', 'michaelstich', 'flushingmeadows', 'instatennis', 'champion', 'grandslam', 'andreagassi']",2018,3,2,13,2018-03-27 13:30:50
106,13824,13718,"['throwback', 'tennis', 'USOpen', 'instawow', 'yonex', 'stantheman', 'flushingmeadows', 'instatennis', 'wawrinka', 'grandslam', 'djokovic']",2018,3,2,8,2018-03-27 08:50:10
13,6215,6202,"['nycskyline', 'instanyc', 'USOpen', 'nycskyscrapers', 'instawow', 'nyc', 'manhattan', 'newyorkviews', 'newyork', 'instaview']",2018,3,1,20,2018-03-26 20:10:43
23,7158,7135,"['sports', 'instasports', 'miami', 'tennis', 'womenstennis', 'USOpen', 'wta', 'instatennis', 'sloanestephens', 'keybiscayne', 'victory']",2018,3,1,15,2018-03-26 15:01:36
16,6119,6103,"['USOpenSeries', 'throwback', 'atp', 'tennis', 'instawow', 'atpworldtour', 'instatennis', 'instamemories', 'murray', 'djokovic', 'cincytennis']",2018,3,1,10,2018-03-26 10:58:29
20,6203,6183,"['throwback', 'gasquet', 'tennis', 'USOpen', 'instawow', 'flushingmeadows', 'instatennis', 'grandslam', 'usopentennis']",2018,3,0,21,2018-03-25 21:27:01
127,17124,16997,"['miami', 'tennis', 'USOpen', 'delpo', 'juanmartindelpotro', 'instatennis', 'delpotro', 'atp', 'protennis']",2018,3,0,17,2018-03-25 17:07:24
53,8404,8351,"['instasports', 'venus', 'miami', 'tennis', 'venuswilliams', 'USOpen', 'wta', 'instatennis', 'protennis']",2018,3,0,15,2018-03-25 15:50:42
235,20316,20081,"['tennis', 'federer', 'instatennis', 'toronto', 'atp', 'usopenseries', 'rogerfederer', 'protennis', 'rogerscup']",2018,3,0,14,2018-03-25 14:23:43
28,5723,5695,"['hewitt', 'throwback', 'tennis', 'USOpen', 'instawow', 'elaynaoui', 'instathrowback', 'flushingmeadows', 'instatennis', 'grandslam', 'usopentennis']",2018,3,0,10,2018-03-25 10:35:31
41,9710,9669,"['instasports', 'tennis', 'mubadalasvc', 'muguruza', 'wta', 'protennis', 'instatennis', 'usopenseries', 'garbinemuguruza']",2018,3,0,1,2018-03-25 01:06:33
393,24009,23616,"['instasports', 'tennis', 'nadal', 'rafaelnadal', 'instatennis', 'usopen', 'rafa', 'atp', 'protennis']",2018,3,6,20,2018-03-24 20:49:40
173,12484,12311,"['thanasikokkinakis', 'instasports', 'miami', 'tennis', 'USOpen', 'instatennis', 'atp', 'kokkinakis', 'protennis']",2018,3,6,18,2018-03-24 18:10:47
54,7262,7208,"['instasports', 'miami', 'tennis', 'USOpen', 'wta', 'radwanska', 'instatennis', 'agnieszkaradwanska', 'protennis']",2018,3,6,15,2018-03-24 15:51:58
23,4104,4081,"['chakvetadze', 'USOpenSeries', 'throwback', 'tennis', 'mubadalasvc', 'wta', 'california', 'instatennis', 'russia', 'tennispro']",2018,3,6,13,2018-03-24 13:17:05
15,6158,6143,"['throwback', 'tennis', 'USOpen', 'picomonaco', 'instawow', 'jamesblake', 'flushingmeadows', 'instatennis', 'grandslam', 'usopentennis']",2018,3,6,10,2018-03-24 10:03:19
13,5153,5140,"['throwback', 'tennis', 'monfils', 'USOpen', 'instawow', 'chucho', 'nyc', 'flushingmeadows', 'instatennis', 'grandslam']",2018,3,5,22,2018-03-23 22:40:35
22,8012,7990,"['sunset', 'USOpenSeries', 'wsopen', 'tennis', 'instasunset', 'winstonsalem', 'atpworldtour', 'instatennis', 'wakeforest', 'atp']",2018,3,5,19,2018-03-23 19:32:49
28,5523,5495,"['instabirthday', 'tennis', 'USOpen', 'gamesetmattek', 'wta', 'happy', 'birthdaywishes', 'birthday', 'instatennis', 'grandslam']",2018,3,5,15,2018-03-23 15:13:45
47,7059,7012,"['throwback', 'tennis', 'USOpen', 'dogsofig', 'steffigraff', 'instapuppy', 'instatennis', 'instadog', 'NationalPuppyDay', 'tennisdog']",2018,3,5,12,2018-03-23 12:20:31
55,5542,5487,"['throwback', 'tennis', 'USOpen', 'guillermocoria', 'nyc', 'fbf', 'flushingmeadows', 'instatennis', 'felixmantilla', 'grandslam']",2018,3,5,9,2018-03-23 09:57:57
31,7137,7106,"['throwback', 'tbt', 'tennis', 'USOpen', 'ferrero', 'flushingmeadows', 'instatennis', 'delpotro', 'grandslam']",2018,3,4,17,2018-03-22 17:55:14
65,10169,10104,"['queens', 'tennis', 'USOpen', 'nyc', 'nycsnow', 'flushingmeadows', 'snowstorm', 'madeinqueens', 'instasnow', 'snow']",2018,3,4,15,2018-03-22 15:24:37
21,4136,4115,"['throwback', 'USOpenSeries', 'tennis', 'instawow', 'wta', 'newhaven', 'instatennis', 'ctopen', 'kuznetsova', 'connecticut', 'tennispro']",2018,3,4,12,2018-03-22 12:42:31
10,2668,2658,"['newk', 'USOpen50', 'throwback', 'tennis', 'USOpen', 'tennisaustralia', 'classic', 'instatennis', 'newcombe', 'vintage', 'grandslam', 'usopentennis']",2018,3,4,10,2018-03-22 10:40:17
39,4577,4538,"['throwback', 'usopenvault', 'tennis', 'USOpen', 'instawow', 'flushingmeadows', 'instatennis', 'chinorios', 'magnuslarsson', 'hotshot']",2018,3,3,21,2018-03-21 21:35:52
119,11097,10978,"['instasports', 'miami', 'tennis', 'instawow', 'wta', 'instatennis', 'usopen', 'naomiosaka', 'protennis']",2018,3,3,18,2018-03-21 18:03:10
76,7638,7562,"['couperogers', 'USOpenSeries', 'throwback', 'tennis', 'andyroddick', 'instawow', 'instatennis', 'baghdatis', 'atp', 'tenniscanada']",2018,3,3,14,2018-03-21 14:49:29
99,13183,13084,"['tennisfashion', 'instabirthday', 'womenstennis', 'tennis', 'USOpen', 'kristynapliskova', 'wta', 'karolinapliskova', 'instatennis', 'womensstyle', 'czech']",2018,3,3,11,2018-03-21 11:55:58
61,6946,6885,"['throwback', 'vitasgerulaitis', 'tennis', 'USOpen', 'nyc', 'classic', 'flushingmeadows', 'instatennis', 'vintage', 'grandslam']",2018,3,3,10,2018-03-21 10:06:48
8,4854,4846,"['bryanbros', 'USOpenSeries', 'instasports', 'tennis', 'atlanta', 'instatennis', 'usopen', 'atp', 'bbtao2018']",2018,3,2,23,2018-03-20 23:06:10
61,11353,11292,"['throwback', 'tennis', 'USOpen', 'instawow', '2006', 'blake', 'federer', 'instatennis', 'flushingmeadows', 'memories', 'grandslam', 'usopentennis']",2018,3,2,21,2018-03-20 21:13:48
35,5012,4977,"['tennis', 'USOpen', 'happiness', 'joy', 'instagood', 'love', 'flushingmeadows', 'instatennis', 'instahappy', 'InternationalHappinessDay', 'grandslam']",2018,3,2,16,2018-03-20 16:24:45
17,4045,4028,"['instasports', 'USOpen50', 'tennis', 'USOpen', 'wta', 'nyc', 'instatennis', 'atp', 'alecbaldwin', 'logo']",2018,3,2,11,2018-03-20 11:48:46
304,6045,5741,"['instasports', 'USOpen50', 'launch', 'tennis', 'USOpen', 'wta', 'nyc', 'instatennis', 'atp', 'logo']",2018,3,2,10,2018-03-20 10:55:57
37,6659,6622,"['instabirthday', 'tennis', 'USOpen', 'happy', 'birthday', 'instatennis', 'champion', 'sloanestephens', 'grandslam']",2018,3,2,9,2018-03-20 09:49:53
21,4572,4551,"['tennis', 'USOpen', 'anchorman', 'comedy', 'willferrell', 'flushingmeadows', 'instatennis', 'humor', 'grandslam']",2018,3,1,22,2018-03-19 22:07:35
15,5224,5209,"['throwback', 'USOpenSeries', 'tennis', 'soderling', 'roddick', 'atpworldtour', 'instatennis', 'atp', 'cincytennis']",2018,3,1,17,2018-03-19 17:24:49
65,8288,8223,"['USOpen50', 'tennis', 'USOpen', 'argentina', 'delpo', 'instatennis', 'champion', 'delpotro', 'atp']",2018,3,1,15,2018-03-19 15:36:25
60,8061,8001,"['USOpenSeries', 'rafanadal', 'throwback', 'tennis', 'nadal', 'canada', 'instatennis', 'toronto', 'tenniscanada']",2018,3,1,10,2018-03-19 10:35:14
105,17291,17186,"['itsaboy', 'tennis', 'instababy', 'wta', 'anaivanovic', 'instatennis', 'bastianschweinsteiger', 'usopen', 'protennis']",2018,3,0,22,2018-03-18 22:24:10
42,4629,4587,"['sharapova', 'USOpenSeries', 'throwback', 'tennis', 'instawow', 'wta', 'dementieva', 'classic', 'instatennis']",2018,3,0,20,2018-03-18 20:51:10
291,25144,24853,"['tennis', 'USOpen', 'argentina', 'atpmasters1000', 'federer', 'instatennis', 'champion', 'delpotro', 'atp', 'indianwells', 'delo']",2018,3,0,18,2018-03-18 18:56:20
139,13548,13409,"['tennis', 'womenstennis', 'USOpen', 'wta', 'instatennis', 'champion', 'indianwells', 'naomiosaka', 'tennispro']",2018,3,0,15,2018-03-18 15:37:21
13,3355,3342,"['USOpen50', 'throwback', 'moments', 'tennis', 'USOpen', 'chrisevert', 'instatennis', 'champion', 'tribute', 'history', 'grandslam']",2018,3,0,13,2018-03-18 13:28:48
14,5880,5866,"['throwback', 'tennis', 'USOpen', 'instawow', 'berdych', 'czech', 'instatennis', 'grandslam', 'usopentennis']",2018,3,0,10,2018-03-18 10:20:14
317,11179,10862,"['instasports', 'tennis', 'USOpen', 'delpo', 'juanmartindelpotro', 'federer', 'instatennis', 'atp', 'indianwells', 'rogerfederer', 'protennis']",2018,3,6,23,2018-03-17 23:24:21
157,18887,18730,"['tennis', 'USOpen', 'instawow', 'california', 'coric', 'federer', 'instatennis', 'atp', 'indianwells', 'rogerfederer']",2018,3,6,16,2018-03-17 16:36:31
7,2445,2438,"['netgeneration', 'tennis', 'USOpen', 'nasa', 'drewfeustel', 'instasport', 'instaspace', 'instatennis', 'TMinusNetGeneration', 'internationalspacestation']",2018,3,6,14,2018-03-17 14:31:24
18,5766,5748,"['throwback', 'tennis', 'USOpen', 'tommyhaas', 'retirement', 'germany', 'instatennis', 'tribute', 'atp', 'grandslam', 'protennis']",2018,3,6,10,2018-03-17 10:42:40
120,12169,12049,"['instasports', 'tennis', 'instawow', 'wta', 'instatennis', 'usopen', 'indianwells', 'naomiosaka', 'protennis']",2018,3,6,3,2018-03-17 03:24:08
103,10989,10886,"['instasports', 'tennis', 'instawow', 'wta', 'instatennis', 'usopen', 'indianwells', 'protennis', 'dariakasatkina']",2018,3,6,1,2018-03-17 01:15:18
13,5145,5132,"['sports', 'sunset', 'USOpenSeries', 'wsopen', 'instasports', 'tennis', 'instatennis', 'usopen', 'atp']",2018,3,5,22,2018-03-16 22:30:55
63,10661,10598,"['instasports', 'tennis', 'delpo', 'instatennis', 'usopen', 'atp', 'indianwells', 'protennis', 'juamartindelpotro']",2018,3,5,19,2018-03-16 19:37:48
23,5058,5035,"['throwback', 'tennis', 'USOpen', 'flushingmeadows', 'instatennis', 'tribute', 'tweener', 'grandslam', 'tommyhaas', 'hotshot', 'legend']",2018,3,5,17,2018-03-16 17:56:03
24,2839,2815,"['instasports', 'USOpen50', 'tennis', 'USOpen', 'wta', 'instatennis', 'martina', 'navratilova', 'usopentennis']",2018,3,5,14,2018-03-16 14:19:35
146,14506,14360,"['throwback', 'swissmaestro', 'tennis', 'USOpen', 'goat', 'federer', 'instatennis', 'champion', 'flushingmeadows', 'grandslam', 'davydenko']",2018,3,5,8,2018-03-16 08:41:25
312,25175,24863,"['instasports', 'tennis', 'federer', 'instatennis', 'usopen', 'atp', 'indianwells', 'rogerfederer', 'protennis']",2018,3,4,23,2018-03-15 23:33:01
132,11222,11090,"['instasports', 'venus', 'tennis', 'venuswilliams', 'wta', 'instatennis', 'usopen', 'indianwells', 'protennis']",2018,3,4,21,2018-03-15 21:27:57
170,9070,8900,"['instasports', 'tennis', 'USOpen', 'tennistraining', 'nadal', 'rafaelnadal', 'instatennis', 'usopen', 'rafa', 'protennis']",2018,3,4,20,2018-03-15 20:40:38
29,4703,4674,"['USOpenSeries', 'CTOpen', 'throwback', 'tennis', 'wta', 'newhaven', 'instatennis', 'connecticut', 'tennispro', 'ctopentennis']",2018,3,4,16,2018-03-15 16:55:12
22,5587,5565,"['throwback', 'tbt', 'tennis', 'USOpen', 'stepanek', 'flushingmeadows', 'instatennis', 'trickshot', 'grandslam', 'djokovic']",2018,3,4,13,2018-03-15 13:32:45
23,4689,4666,"['instasports', 'USOpen50', 'tennis', 'USOpen', 'kerber', 'wta', 'instatennis', 'usopentennis', 'angeliquekerber']",2018,3,4,11,2018-03-15 11:07:07
97,11808,11711,"['instasports', 'tennis', 'montreal', 'juanmartindelpotro', 'delpo', 'instatennis', 'atp', 'usopenseries', 'protennis']",2018,3,3,23,2018-03-14 23:47:54
96,15423,15327,"['instasports', 'NextGenATP', 'tennis', 'federer', 'instatennis', 'usopen', 'atp', 'indianwells', 'rogerfederer', 'protennis']",2018,3,3,20,2018-03-14 20:49:52
135,11330,11195,"['couperogers', 'USOpenSeries', 'rafanadal', 'throwback', 'tennis', 'montreal', 'nadal', 'atpworldtour', 'instatennis', 'atp', 'rogerscup']",2018,3,3,14,2018-03-14 14:49:18
11,2546,2535,"['netgeneration', 'tennis', 'USOpen', 'instawow', 'TminusNetGeneration', 'nasa', 'internationalspacestation', 'astronaut', 'instatennis', 'spacetravel', 'andrewfeustel', 'instaspace']",2018,3,3,12,2018-03-14 12:10:32
15,4327,4312,"['samquerrey', 'bbtatlantaopen', 'instasports', 'tennis', 'atlanta', 'instatennis', 'atp', 'usopenseries', 'protennis']",2018,3,3,1,2018-03-14 01:19:53
72,7605,7533,"['ithf', 'throwback', 'patrafter', 'tennis', 'USOpen', 'rafter', 'tennisaustralia', 'flushingmeadows', 'instatennis', 'champion', 'grandslam']",2018,3,2,23,2018-03-13 23:22:28
21,3484,3463,"['ustennis', 'tennis', 'motivation', 'atpworldtour', 'instatennis', 'champion', 'atp', 'jimcourier', 'grandslam', 'legend']",2018,3,2,17,2018-03-13 17:01:00
36,6814,6778,"['throwback', 'tennis', 'USOpen', 'instawow', 'robredo', 'flushingmeadows', 'instatennis', 'grandslam', 'djokovic']",2018,3,2,11,2018-03-13 11:28:47
263,19375,19112,"['instasports', 'venus', 'tennis', 'serena', 'venuswilliams', 'wta', 'serenawilliams', 'instatennis', 'usopen', 'womenwhoinspire', 'indianwells', 'protennis']",2018,3,2,0,2018-03-13 00:00:05
27,7733,7706,"['cincinnati', 'instasports', 'wsopen', 'tennis', 'wta', 'carolinewozniacki', 'instatennis', 'usopenseries', 'protennis']",2018,3,1,21,2018-03-12 21:33:42
40,4309,4269,"['instasports', 'venus', 'tennis', 'venuswilliams', 'serena', 'wta', 'serenawilliams', 'instatennis', 'usopen', 'indianwells', 'protennis']",2018,3,1,18,2018-03-12 18:52:16
164,28351,28187,"['instasports', 'tennis', 'federer', 'instatennis', 'usopen', 'atp', 'indianwells', 'rogerfederer', 'protennis']",2018,3,1,17,2018-03-12 17:50:08
59,7242,7183,"['USOpenSeries', 'Besties', 'athlete', 'venuswilliams', 'Sisters', 'serenawilliams', 'instafamily', 'IndianWells']",2018,3,1,10,2018-03-12 10:08:30
276,27023,26747,"['instasports', 'tennis', 'federer', 'instatennis', 'usopen', 'atp', 'indianwells', 'rogerfederer', 'protennis']",2018,3,0,19,2018-03-11 19:20:53
51,8697,8646,"['instasports', 'tennis', 'USOpen', 'instawow', 'wta', 'instatennis', 'amandaanisimova', 'indianwells', 'protennis']",2018,3,0,15,2018-03-11 15:21:06
24,8503,8479,"['USOpenSeries', 'tennis', 'wta', 'canada', 'instatennis', 'toronto', 'summer', 'atp', 'tenniscanada', 'protennis']",2018,3,0,12,2018-03-11 12:21:37
39,4970,4931,"['robertobautistaagut', 'instasports', 'tennis', 'northcarolina', 'winstonsalem', 'instatennis', 'atp', 'usopenseries', 'protennis']",2018,3,6,23,2018-03-10 23:31:12
213,22730,22517,"['Besties', 'athlete', 'USOpen', 'venuswilliams', 'serena', 'Sisters', 'serenawilliams', 'IndianWells', 'Goat']",2018,3,6,20,2018-03-10 20:14:01
84,7640,7556,"['throwback', 'tennis', 'USOpen', 'instawow', 'schiavone', 'wta', 'flushingmeadows', 'instatennis', 'italy', 'tweener', 'grandslam']",2018,3,6,8,2018-03-10 08:50:07
39,10145,10106,"['instanyc', 'nycskyline', 'citythatneversleeps', 'USOpen', 'skylinevista', 'instawow', 'nyc', 'instavista', 'newyorkviews']",2018,3,5,19,2018-03-09 19:15:44
3,4389,4386,"['USOpenSeries', 'CTOpen', 'summertennis', 'tennis', 'womenstennis', 'wta', 'newhaven', 'instatennis', 'connecticut', 'yale', 'ctopentennis']",2018,3,5,14,2018-03-09 14:17:38
52,5161,5109,"['throwback', 'tennis', 'USOpen', 'kournikova', 'instawow', 'fbf', 'vault', 'henin', 'instatennis', 'flushingmeadows', 'grandslam']",2018,3,5,10,2018-03-09 10:13:13
275,26143,25868,"['instasports', 'tennis', 'serena', 'wta', 'serenawilliams', 'instatennis', 'usopen', 'indianwells', 'protennis']",2018,3,5,1,2018-03-09 01:07:21
8,2940,2932,"['throwback', 'agassi', 'tennis', 'USOpen', 'instawow', 'flushingmeadows', 'instatennis', 'grandslam', 'vinciguerra', 'usopentennis']",2018,3,4,23,2018-03-08 23:57:27
31,3426,3395,"['tennis', 'venuswilliams', 'USOpen', 'martinanavratilova', 'InternationalWomensDay', 'wta', 'steffigraf', 'serenawilliams', 'monicaseles', 'mariasharapova', 'protennis', 'instatennis', 'justinehenin', 'billiejeanking', 'kimclijsters']",2018,3,4,17,2018-03-08 17:52:29
12,4424,4412,"['instabirthday', 'petrakvitova', 'tennis', 'USOpen', 'wta', 'happy', 'birthday', 'instatennis']",2018,3,4,15,2018-03-08 15:39:16
84,16689,16605,"['petrakvitova', 'tennis', 'simonahalep', 'flaviapennetta', 'agaradwanska', 'women', 'serenawilliams', 'InternationalWomensDay', 'carolinegarcia', 'carolinewozniacki', 'elinasvitolina', 'billiejeanking', 'karolinapliskova', 'womenwhoinspire', 'jelenaostapenko', 'garbinemuguruza', 'luciesafarova', 'venuswilliams', 'wta', 'mariasharapova', 'angeliquekerber']",2018,3,4,11,2018-03-08 11:56:37
33,9601,9568,"['instasports', 'USOpenSeries', 'elenavesnina', 'tennis', 'wta', 'instatennis', 'atp', 'indianwells', 'rogerfederer']",2018,3,4,9,2018-03-08 09:59:27
62,7417,7355,"['throwback', 'jcf', 'tennis', 'ferrero', 'USOpen', 'instawow', 'flushingmeadows', 'instatennis', 'tweener', 'grandslam']",2018,3,3,21,2018-03-07 21:54:19
22,5001,4979,"['tennis', 'USOpen', 'goat', 'federer', 'instatennis', 'flushingmeadows', 'trophy', 'champion', 'grandslam', 'rogerfederer', 'protennis']",2018,3,3,16,2018-03-07 16:20:24
40,5459,5419,"['tennis', 'serena', 'support', 'bnpparibasopen', 'wta', 'serenawilliams', 'charity', 'instatennis', 'comeback', 'indianwells']",2018,3,3,12,2018-03-07 12:45:04
34,4945,4911,"['throwback', 'tennis', 'USOpen', 'happy', 'ivan', 'birthday', 'instatennis', 'champion', 'grandslam', 'lendl']",2018,3,3,11,2018-03-07 11:15:01
41,7480,7439,"['throwback', 'tennis', 'USOpen', 'instawow', 'youzhny', 'instatennis', 'grandslam', 'djokovic', 'hotshot']",2018,3,2,23,2018-03-06 23:57:47
50,12824,12774,"['netgeneration', 'depotro', 'tennis', 'USOpen', 'instatennis', 'fun', 'indianwells', 'delthortro']",2018,3,2,18,2018-03-06 18:49:02
6,3273,3267,"['USOpenSeries', 'throwback', 'tennis', 'atlanta', 'bbtao', 'instatennis', 'atp', 'isner', 'anderson']",2018,3,2,17,2018-03-06 17:17:00
20,4281,4261,"['throwback', 'tennis', 'USOpen', 'happy', 'radwanska', 'instasport', 'birthday', 'instatennis', 'grandslam']",2018,3,2,13,2018-03-06 13:57:37
7,2171,2164,"['instasports', 'athlete', 'tennis', 'USOpen', 'NationalSportsmanshipDay', 'sportsmanship', 'grace', 'instatennis', 'excellence', 'grandslam', 'award']",2018,3,2,11,2018-03-06 11:27:53
60,6405,6345,"['tennis', 'USOpen', 'tennistraining', 'training', 'novakdjokovic', 'workout', 'atp', 'djokovic', 'instaworkout']",2018,3,2,9,2018-03-06 09:35:58
42,12590,12548,"['instasports', 'tennis', 'sanjose', 'federer', 'instatennis', 'usopen', 'MatchForAfrica', 'rogerfederer', 'protennis']",2018,3,2,1,2018-03-06 01:40:35
16,3051,3035,"['svitolina', 'msg', 'instasports', 'tennis', 'USOpen', 'TB10NewYork', 'wta', 'instatennis', 'tiebreaktens']",2018,3,1,22,2018-03-05 22:17:12
115,10931,10816,"['tennis', 'USOpen', 'wta', 'bnpparibasopen', 'serenawilliams', 'california', 'instatennis', 'comeback', 'champion', 'indianwells']",2018,3,1,18,2018-03-05 18:30:46
8,3446,3438,"['cocovandeweghe', 'instasports', 'msg', 'tennis', 'USOpen', 'TB10NewYork', 'wta', 'instatennis', 'NYC', 'madisonsquaregarden']",2018,3,1,15,2018-03-05 15:29:50
72,6872,6800,"['instasports', 'edberg', 'krickstein', 'tennis', 'USOpen', 'instawow', 'classic', 'flushingmeadows', 'instatennis', 'grandslam']",2018,3,1,14,2018-03-05 14:18:07
4,2445,2441,"['sports', 'cincinnati', 'USOpenSeries', 'tennis', 'wta', 'instatennis', 'usopen', 'atp', 'cincytennis']",2018,3,1,11,2018-03-05 11:48:59
11,3404,3393,"['instabirthday', 'celebration', 'tennis', 'USOpen', 'gavrilova', 'happy', 'tennisaustralia', 'instatennis', 'birthday']",2018,3,1,8,2018-03-05 08:36:08
106,13364,13258,"['redcarpet', 'tennis', 'muguruza', 'Oscar', 'instaglam', 'offdutystyle', 'tennisplayer', 'oscars2018']",2018,3,0,21,2018-03-04 21:24:24
19,4609,4590,"['throwback', 'USOpenSeries', 'tennis', 'wta', 'monicaseles', 'feelgoodstuff', 'instatennis', 'toronto', 'tenniscanada', 'rogerscup', 'inspiration']",2018,3,0,14,2018-03-04 14:58:09
11,4737,4726,"['throwback', 'tennis', 'USOpen', 'instawow', 'maratsafin', 'instathrowback', 'instatennis', 'enqvist', 'grandslam', 'usopentennis']",2018,3,0,11,2018-03-04 11:36:11
172,18090,17918,"['tennis', 'juanmartindelpotro', 'acapulco', 'delpo', 'instatennis', 'delpotro', 'usopen', 'atp', 'protennis']",2018,3,0,0,2018-03-04 00:15:43
24,9352,9328,"['nycskyline', 'newyork', 'USOpen', 'weekend', 'instawow', 'manhattan', 'newyorkviews', 'NYC', 'nycviews']",2018,3,6,21,2018-03-03 21:14:30
58,9462,9404,"['instasports', 'tennis', 'wta', 'doubles', 'instatennis', 'usopen', 'atp', 'indianwells', 'protennis']",2018,3,6,15,2018-03-03 15:32:34
49,7035,6986,"['USOpenSeries', 'sun', 'tennis', 'azarenka', 'vika', 'wta', 'bnpparibasopen', 'california', 'instatennis', 'protennis']",2018,3,6,10,2018-03-03 10:57:58
182,16225,16043,"['instasports', 'tennis', 'juanmartindelpotro', 'acapulco', 'delpo', 'instatennis', 'delpotro', 'usopen', 'atp', 'protennis']",2018,3,6,1,2018-03-03 01:51:15
85,8870,8785,"['throwback', 'Blake', 'hotshots', 'tennis', 'USOpen', 'instawow', 'winners', 'instatennis', 'forehands', 'grandslam']",2018,3,5,20,2018-03-02 20:48:13
21,5658,5637,"['sports', 'sunset', 'USOpenSeries', 'wsopen', 'tennis', 'winstonsalem', 'instatennis', 'atp', 'instsports']",2018,3,5,18,2018-03-02 18:09:37
8,2196,2188,"['USOpen50', 'throwback', 'tennis', 'USOpen', 'instatennis', 'openera', 'spanishtennis', 'manuelorantes', 'grandslam', 'protennis']",2018,3,5,15,2018-03-02 15:19:01
71,8714,8643,"['throwback', 'tennis', 'USOpen', 'instawow', 'cuevas', 'fbf', 'dudisela', 'instatennis', 'trickshot', 'grandslam']",2018,3,5,11,2018-03-02 11:05:38
66,11367,11301,"['instasports', 'tennis', 'juanmartindelpotro', 'acapulco', 'delpo', 'instatennis', 'delpotro', 'usopen', 'atp', 'protennis']",2018,3,5,1,2018-03-02 01:09:50
80,10714,10634,"['tennis', 'rematch', 'USOpen', 'acapulco', 'forehand', 'instatennis', 'thiem', 'delpotro', 'grandslam', 'delthortro']",2018,3,4,18,2018-03-01 18:16:41
209,6725,6516,"['sports', 'instasports', 'USOpen50', 'tennis', 'USOpen', 'wta', 'instatennis', 'tennishistory', 'atp', 'grandslam']",2018,3,4,14,2018-03-01 14:07:17
14,5552,5538,"['throwback', 'USOpenSeries', 'motivation', 'wta', 'newhaven', 'ctopen', 'ctopentennis', 'kimclijsters']",2018,3,4,12,2018-03-01 12:33:14
163,8181,8018,"['throwback', 'tbt', 'tennis', 'USOpen', 'flushingmeadows', 'instatennis', 'draw', 'grandslam', 'drawsheet']",2018,3,4,10,2018-03-01 10:59:19
95,10036,9941,"['throwback', 'tennis', 'borisbecker', 'USOpen', 'vault', 'flushingmeadows', 'instatennis', 'atp', 'grandslam', 'protennis']",2018,2,3,23,2018-02-28 23:55:03
168,12157,11989,"['instasports', 'tennis', 'wta', 'victoriaazarenka', 'instatennis', 'usopen', 'womenwhoinspire', 'indianwells', 'protennis']",2018,2,3,22,2018-02-28 22:16:42
18,3762,3744,"['sports', 'instasports', 'USOpenSeries', 'tennis', 'wta', 'canada', 'instatennis', 'usopen', 'tenniscanada']",2018,2,3,16,2018-02-28 16:14:07
16,3957,3941,"['instabirthday', 'tennis', 'USOpen', 'wta', 'happy', 'instasport', 'birthday', 'jelenajankovic', 'instatennis']",2018,2,3,13,2018-02-28 13:19:51
69,4720,4651,"['sports', 'tennis', 'USOpen', 'serena', 'wta', 'serenawilliams', 'instalove', 'instafamily', 'instatennis']",2018,2,3,11,2018-02-28 11:18:08
16,4980,4964,"['throwback', 'fish', 'tennis', 'USOpen', 'instasport', 'tennispro', 'doubles', 'instatennis', 'grandslam', 'gonzalez']",2018,2,3,8,2018-02-28 08:51:01
73,5339,5266,"['instasports', 'tennis', 'USOpen', 'blackpanther', 'francestiafoe', 'nextgenatp', 'USTennis', 'superhero', 'instatennis', 'atp', 'protennis']",2018,2,2,21,2018-02-27 21:27:54
12,4301,4289,"['instasports', 'USOpenSeries', 'tennis', 'bbtatlantopen', 'bbtao', 'instatennis', 'johnisner', 'atp', 'isner']",2018,2,2,20,2018-02-27 20:11:33
12,2575,2563,"['instasports', 'USOpen50', 'edberg', 'tennis', 'Edberg', 'USOpen', 'stefanedberg', 'instatennis', 'atp', 'grandslam']",2018,2,2,19,2018-02-27 19:08:33
153,29042,28889,"['tennis', 'USOpen', 'serena', 'laureussport', 'laureus', 'laureusawards', 'federer', 'instatennis', 'champions']",2018,2,2,15,2018-02-27 15:22:35
54,6054,6000,"['instasports', 'vinci', 'tennis', 'pennetta', 'USOpen', 'wta', 'instatennis', 'instabuddies', 'friends', 'grandslam']",2018,2,2,13,2018-02-27 13:18:41
102,8654,8552,"['CincyTennis', 'cincinnati', 'USOpenSeries', 'tennis', 'instaguess', 'guesstheplayer', 'atpworldtour', 'instatennis', 'summer', 'memories', 'atp']",2018,2,2,10,2018-02-27 10:22:01
38,7452,7414,"['throwback', 'rafanadal', 'usopenvault', 'tennis', 'USOpen', 'nadal', 'vamosrafa', 'instatennis', 'doubles', 'grandslam']",2018,2,1,18,2018-02-26 18:42:37
9,3490,3481,"['arthurashe', 'tennis', 'jamesblake', 'BHM', 'BlackHistoryMonth', 'zinagarrison', 'instasport', 'instatennis', 'USTAEmbraceAll', 'altheagibson', 'diversity']",2018,2,1,16,2018-02-26 16:07:03
56,7928,7872,"['instabirthday', 'tennis', 'USOpen', 'wta', 'happy', 'instatennis', 'birthday', 'champion', 'grandslam', 'legend', 'lina']",2018,2,1,13,2018-02-26 13:08:05
37,4588,4551,"['instasports', 'USOpen50', 'tennis', 'USOpen', 'maratsafin', 'instatennis', 'openera', 'atp', 'grandslam', 'safin']",2018,2,1,10,2018-02-26 10:24:18
40,5531,5491,"['USOpenSeries', 'tennis', 'wta', 'instasunset', 'instatennis', 'usopen', 'atp', 'tenniscanada', 'rogerscup']",2018,2,0,21,2018-02-25 21:53:29
75,10448,10373,"['instasports', 'NextGenATP', 'tennis', 'francestiafoe', 'nextgenatp', 'delraybeach', 'instatennis', 'usopen', 'atp', 'protennis']",2018,2,0,16,2018-02-25 16:21:46
95,14255,14160,"['instasports', 'tennis', 'nadal', 'acapulco', 'rafaelnadal', 'instatennis', 'usopen', 'atp', 'protennis']",2018,2,0,15,2018-02-25 15:16:27
45,8945,8900,"['throwback', 'usopenvault', 'tennis', 'USOpen', 'instawow', 'flushingmeadows', 'instatennis', 'grandslam', 'usopentennis']",2018,2,0,11,2018-02-25 11:51:25
120,8781,8661,"['throwback', 'underthelights', 'tennis', 'guga', 'USOpen', 'gugakuerten', 'flushingmeadows', 'instatennis', 'brazil', 'grandslam']",2018,2,0,0,2018-02-25 00:02:55
21,6209,6188,"['instasports', 'tennis', 'instawow', 'wta', 'instatennis', 'elinasvitolina', 'usopenseries', 'dubai', 'protennis']",2018,2,6,22,2018-02-24 22:14:55
85,20980,20895,"['instasports', 'tennis', 'olympics', 'USOpen', 'venuswilliams', 'andymurray', 'olympicgames', 'stanwawrinka', 'rafaelnadal', 'serenawilliams', 'instatennis', 'rogerfederer']",2018,2,6,19,2018-02-24 19:19:12
26,8274,8248,"['tennis', 'USOpen', 'centralpark', 'instawow', 'trophytour', 'manhattan', 'ny', 'instatennis', 'newyork', 'grandslam', 'nycviews']",2018,2,6,17,2018-02-24 17:08:11
98,13674,13576,"['tennis', 'USOpen', 'instasport', 'friendship', 'instahug', 'instatennis', 'fun', 'grandslam', 'hug']",2018,2,6,11,2018-02-24 11:15:14
28,5659,5631,"['instabirthday', 'lleytonhewitt', 'throwback', 'tennis', 'USOpen', 'rusty', 'tennisaustralia', 'hewbeauty', 'instatennis', 'happybirthday']",2018,2,5,21,2018-02-23 21:38:19
45,7545,7500,"['throwback', 'tennis', 'USOpen', 'instawow', 'backhand', 'flushingmeadows', 'instatennis', 'grandslam', 'ljubicic']",2018,2,5,18,2018-02-23 18:13:44
24,7057,7033,"['USOpenSeries', 'gaelmonfils', 'tennis', 'instawow', 'winstonsalem', 'lamonf', 'instatennis', 'wakeforest', 'quotes', 'atp', 'feels']",2018,2,5,14,2018-02-23 14:41:14
59,6441,6382,"['instasports', 'throwback', 'tennis', 'USOpen', 'moya', 'flushingmeadows', 'instatennis', 'grandslam', 'massu']",2018,2,5,9,2018-02-23 09:10:04
135,13881,13746,"['instasports', 'tennis', 'francestiafoe', 'nextgenatp', 'delraybeach', 'instatennis', 'usopen', 'atp', 'protennis']",2018,2,4,23,2018-02-22 23:46:15
38,6231,6193,"['throwback', 'tbt', 'venus', 'tennis', 'USOpen', 'hingis', 'instawow', 'rivals', 'classic', 'flushingmeadows', 'grandslam']",2018,2,4,22,2018-02-22 22:09:34
28,4939,4911,"['ustennis', 'tennis', 'USOpen', 'gigifernandez', 'happy', 'birthday', 'instatennis', 'doubles', 'halloffamer']",2018,2,4,17,2018-02-22 17:39:57
21,3421,3400,"['sports', 'instasports', 'USOpen50', 'tennis', 'USOpen', 'wta', 'instatennis', 'tennishistory', 'atp', 'grandslam']",2018,2,4,15,2018-02-22 15:22:34
57,7310,7253,"['tbt', 'tennis', 'USOpen', 'wta', 'evert', 'womenwhoinspire', 'instatennis', 'instamemories', 'navratilova', 'legends']",2018,2,4,12,2018-02-22 12:10:17
6,2859,2853,"['USOpen50', 'tennis', 'USOpen', 'bobbryan', 'mikebryan', 'bryanbrothers', 'instatennis', 'atp', 'grandslam']",2018,2,4,9,2018-02-22 09:45:53
77,19526,19449,"['instasports', 'USOpenSeries', 'throwback', 'tennis', 'swiss', 'olympics', 'montreal', 'instawow', 'hockey', 'federer', 'atp', 'usos']",2018,2,3,20,2018-02-21 20:13:06
13,2985,2972,"['sports', 'instasports', 'USOpen50', 'tennis', 'FlaviaPennetta', 'USOpen', 'wta', 'instatennis', 'instaitaly', 'Vinci']",2018,2,3,17,2018-02-21 17:24:57
12,3847,3835,"['tennis', 'USOpen', 'happy', 'forza', 'flushingmeadows', 'birthday', 'instatennis', 'seppi', 'italy', 'memories', 'grandslam']",2018,2,3,15,2018-02-21 15:57:47
200,24643,24443,"['ustennis', 'throwback', 'agassi', 'tennis', 'champions', 'USOpen', 'instatennis', 'grandslam', 'sampras']",2018,2,3,13,2018-02-21 13:27:33
106,27181,27075,"['nycskyline', 'tennis', 'instawow', 'nyc', 'manhattan', 'federer', 'instatennis', 'newyork', 'grandslam', 'rogerfederer']",2018,2,2,23,2018-02-20 23:41:00
71,10596,10525,"['instasports', 'tennis', 'juanmartindelpotro', 'delpo', 'delraybeach', 'instatennis', 'delpotro', 'usopen', 'atp', 'protennis']",2018,2,2,21,2018-02-20 21:45:29
59,16063,16004,"['throwbackthursday', 'Laver', 'Wimbledon', 'tbt', 'Ashe']",2018,4,4,9,2018-04-05 09:15:39
41,15837,15796,['Wimbledon'],2018,4,3,3,2018-04-04 03:07:42
32,14693,14661,"['sport', 'Wimbledon', 'instasport', 'tennis']",2018,4,0,15,2018-04-01 15:53:35
381,35955,35574,"['aprilfools', 'Wimbledon', 'tennis', 'sport', 'instasport']",2018,4,0,5,2018-04-01 05:48:00
46,14378,14332,[],2018,3,6,15,2018-03-31 15:01:15
35,10826,10791,"['china', 'Wimbledon', 'tennis', 'sport', 'beijing', 'instasport']",2018,3,4,14,2018-03-29 14:48:23
42,18924,18882,['Wimbledon'],2018,3,4,11,2018-03-29 11:04:01
111,17925,17814,"['sport', 'Wimbledon', 'instasport', 'tennis']",2018,3,3,13,2018-03-28 13:01:20
61,17566,17505,"['Wimbledon', 'tennis', 'sport', 'construction', 'instasport']",2018,3,2,16,2018-03-27 16:56:01
25,7428,7403,['Wimbledon'],2018,3,1,13,2018-03-26 13:30:16
26,10286,10260,"['Wimbledon', 'india', 'instasport', 'tennis']",2018,3,1,11,2018-03-26 11:59:07
173,35153,34980,[],2018,3,0,17,2018-03-25 17:10:01
35,15191,15156,"['bluesky', 'sun', 'Wimbledon', 'weather', 'summer', 'tennis']",2018,3,0,13,2018-03-25 13:14:23
69,7266,7197,[],2018,3,6,11,2018-03-24 11:35:53
70,16275,16205,"['throwbackthursday', 'Evert', 'Wimbledon', 'Navratilova', 'onthisday', 'tbt', 'tennis']",2018,3,4,11,2018-03-22 11:48:38
37,10935,10898,[],2018,3,3,15,2018-03-21 15:11:07
34,11706,11672,"['Wimbledon', 'tennis', 'sport', 'india', 'instasport']",2018,3,2,17,2018-03-20 17:24:47
240,44901,44661,"['springequinox', 'instasport', 'flowers', 'spring', 'Wimbledon', 'sport', 'tennis']",2018,3,2,13,2018-03-20 13:23:10
22,11368,11346,"['snowy', 'instasport', 'Wimbledon', 'sport', 'snow', 'tennis']",2018,3,1,8,2018-03-19 08:05:06
114,24278,24164,[],2018,3,0,19,2018-03-18 19:04:48
37,11372,11335,[],2018,3,0,16,2018-03-18 16:03:26
47,23844,23797,"['sport', 'Wimbledon', 'instasport', 'tennis']",2018,3,6,18,2018-03-17 18:15:19
121,31345,31224,"['motivation', 'Wimbledon', 'tennis', 'sport', 'instasport']",2018,3,5,7,2018-03-16 07:47:28
214,18388,18174,['Wimbledon'],2018,3,3,16,2018-03-14 16:26:43
49,14789,14740,"['sport', 'Wimbledon', 'instasport', 'tennis']",2018,3,2,13,2018-03-13 13:22:45
55,16563,16508,"['sport', 'Wimbledon', 'instasport', 'tennis']",2018,3,1,6,2018-03-12 06:19:46
56,18705,18649,"['motivation', 'instasport', 'Wimbledon', 'inspiration', 'sport', 'tennis']",2018,3,5,7,2018-03-09 07:10:17
14,8176,8162,"['sport', 'Wimbledon', 'instasport', 'tennis']",2018,3,4,16,2018-03-08 16:07:44
237,21202,20965,"['Wimbledon', 'IWD2018']",2018,3,4,8,2018-03-08 08:03:42
52,9875,9823,[],2018,3,2,14,2018-03-06 14:48:33
43,16599,16556,"['instasport', 'Oscars2018', 'Wimbledon', 'sport', 'Oscars', 'tennis']",2018,3,1,4,2018-03-05 04:55:27
45,14568,14523,[],2018,3,0,16,2018-03-04 16:52:46
35,17554,17519,"['ice', 'frozen', 'frost', 'cold', 'wimbledon', 'winter', 'tennis']",2018,3,5,7,2018-03-02 07:09:14
190,15107,14917,"['snowy', 'snowday', 'Wimbledon', 'Tennis', 'sport', 'snow', 'instasport']",2018,3,4,8,2018-03-01 08:40:24
114,23809,23695,"['Snow', 'snowday', 'wimbledon', 'winter', 'tennis']",2018,2,3,12,2018-02-28 12:20:21
171,44758,44587,"['sport', 'Wimbledon', 'laureus18', 'tennis']",2018,2,2,15,2018-02-27 15:17:14
109,15642,15533,['Wimbledon'],2018,2,1,12,2018-02-26 12:58:59
33,12470,12437,"['Wimbledon', 'olympics', 'snow', 'pyeongchang2018', 'tennis']",2018,2,1,6,2018-02-26 06:16:08
971,41188,40217,"['sport', 'Wimbledon', 'instasport', 'tennis']",2018,2,0,13,2018-02-25 13:32:45
128,18335,18207,[],2018,2,6,8,2018-02-24 08:27:14
161,35376,35215,"['throwbackthursday', 'throwback', 'TBT', 'Wimbledon', 'tennis']",2018,2,4,12,2018-02-22 12:51:06
52,16754,16702,['Wimbledon'],2018,2,3,13,2018-02-21 13:56:27
100,13887,13787,"['flowers', 'summer', 'Wimbledon', 'sport', 'flower', 'tennis']",2018,2,2,10,2018-02-20 10:30:32
352,50254,49902,"['MondayMotivation', 'Wimbledon']",2018,2,1,11,2018-02-19 11:06:23
35,12718,12683,[],2018,2,0,12,2018-02-18 12:35:24
84,38806,38722,[],2018,2,0,12,2018-02-18 12:05:42
383,65282,64899,"['sport', 'Wimbledon', 'instasport', 'tennis']",2018,2,5,15,2018-02-16 15:03:38
134,17735,17601,['Wimbledon'],2018,2,5,10,2018-02-16 10:56:13
127,26081,25954,['Wimbledon'],2018,2,5,7,2018-02-16 07:29:53
32,16901,16869,"['throwback', 'retro', 'TBT', 'Wimbledon', 'tennis', 'sport', 'instasport']",2018,2,4,7,2018-02-15 07:19:41
211,28353,28142,"['Wimbledon', 'ValentinesDay']",2018,2,3,12,2018-02-14 12:35:46
100,34220,34120,"['Wimbledon', 'ValentinesDay']",2018,2,3,7,2018-02-14 07:48:51
44,10591,10547,['Wimbledon'],2018,2,2,14,2018-02-13 14:34:19
108,23118,23010,['Wimbledon'],2018,2,0,17,2018-02-11 17:51:46
61,19114,19053,[],2018,2,6,16,2018-02-10 16:07:12
41,14377,14336,"['sport', 'Wimbledon', 'instasport', 'tennis']",2018,2,5,7,2018-02-09 07:24:26
55,23315,23260,"['instasport', 'ThrowbackThursday', 'throwback', 'Wimbledon', 'sport', 'tbt', 'tennis']",2018,2,4,7,2018-02-08 07:22:04
111,28327,28216,"['throwback', 'Wimbledon', 'tennis']",2018,2,3,12,2018-02-07 12:21:55
54,15733,15679,"['Wimbledon', 'dog', 'tennis', 'sport', 'instasport']",2018,2,3,9,2018-02-07 09:14:20
95,19695,19600,[],2018,2,2,15,2018-02-06 15:41:38
52,16326,16274,[],2018,2,2,11,2018-02-06 11:43:26
81,19100,19019,"['sport', 'Wimbledon', 'instasport', 'tennis']",2018,2,1,12,2018-02-05 12:49:51
294,22025,21731,"['throwback', 'Wimbledon', 'tennis', 'sport', 'tbt', 'instasport']",2018,2,4,16,2018-02-01 16:20:20
39,16952,16913,[],2018,1,2,15,2018-01-30 15:08:50
209,47949,47740,['MondayMotivation'],2018,1,1,9,2018-01-29 09:26:43
40,26797,26757,"['MondayMotivation', 'Wimbledon', 'tennis', 'sport', 'instasport']",2018,1,1,6,2018-01-29 06:20:35
204,66816,66612,"['sport', 'Wimbledon', 'tennis']",2018,1,0,9,2018-01-28 09:48:45
631,98576,97945,[],2018,1,0,6,2018-01-28 06:40:41
293,46605,46312,[],2018,1,6,6,2018-01-27 06:27:00
662,59331,58669,['Wimbledon'],2018,1,5,4,2018-01-26 04:58:13
90,14976,14886,['Wimbledon'],2018,1,4,19,2018-01-25 19:09:13
25,12111,12086,[],2018,1,4,10,2018-01-25 10:10:07
17,6950,6933,[],2018,1,4,8,2018-01-25 08:19:32
300,34081,33781,[],2018,1,4,3,2018-01-25 03:23:03
249,25588,25339,[],2018,1,3,6,2018-01-24 06:19:21
646,45454,44808,[],2018,1,3,5,2018-01-24 05:51:10
107,25233,25126,"['sport', 'Wimbledon', 'instasport', 'tennis']",2018,1,3,1,2018-01-24 01:37:57
35,10470,10435,[],2018,1,2,10,2018-01-23 10:56:20
125,20892,20767,[],2018,1,2,1,2018-01-23 01:42:52
256,31481,31225,"['Wimbledon', 'tennis', 'sport', 'mondaymotivation', 'instasport']",2018,1,1,6,2018-01-22 06:45:30
25,18978,18953,[],2018,1,1,1,2018-01-22 01:56:51
120,21405,21285,"['sport', 'Wimbledon', 'instasport', 'tennis']",2018,1,0,11,2018-01-21 11:30:59
93,16822,16729,[],2018,1,5,23,2018-01-19 23:42:46
54,10404,10350,"['sport', 'Wimbledon', 'instasport', 'tennis']",2018,1,5,10,2018-01-19 10:27:06
215,28265,28050,"['sport', 'Wimbledon', 'instasport', 'tennis']",2018,1,5,7,2018-01-19 07:13:47
29,11454,11425,"['sport', 'Wimbledon', 'community', 'tennis']",2018,1,4,5,2018-01-18 05:17:01
447,45940,45493,[],2018,1,3,7,2018-01-17 07:16:42
81,16934,16853,[],2018,1,3,1,2018-01-17 01:33:57
41,17875,17834,"['Wimbledon', 'tennis', 'wimbledon', 'sport', 'instasport']",2018,1,2,2,2018-01-16 02:54:55
42,16803,16761,['MondayMotivation'],2018,1,1,5,2018-01-15 05:43:21
179,19785,19606,[],2018,1,1,3,2018-01-15 03:38:25
123,30889,30766,"['sport', 'Wimbledon', 'instasport', 'tennis']",2018,1,5,18,2018-01-12 18:53:58
93,20506,20413,"['throwback', 'TBT', 'Wimbledon', 'tennis', 'sport', 'instasport']",2018,1,4,15,2018-01-11 15:01:30
56,16440,16384,"['sport', 'Wimbledon', 'tennis']",2018,1,2,14,2018-01-09 14:31:13
59,17805,17746,"['bluesky', 'sun', 'Wimbledon', 'tennis', 'sport', 'summer', 'instasport']",2018,1,0,15,2018-01-07 15:13:05
423,39752,39329,"['Wimbledon', 'tennis', 'sport', 'tbt', 'instasport']",2018,1,4,11,2018-01-04 11:10:00
105,24807,24702,[],2018,1,4,5,2018-01-04 05:10:40
51,14877,14826,"['Wimbledon', '2018', 'tennis', 'sport', 'instasport']",2018,1,1,12,2018-01-01 12:23:26
104,33009,32905,['2017bestnine'],2017,12,0,21,2017-12-31 21:55:51
243,27827,27584,['Wimbledon'],2017,12,0,12,2017-12-31 12:37:27
215,21552,21337,"['sport', 'Wimbledon', 'instasport', 'tennis']",2017,12,5,10,2017-12-29 10:22:01
855,47725,46870,"['TBT', 'Wimbledon', 'tennis', 'sport', 'instasport']",2017,12,4,12,2017-12-28 12:03:56
24,12593,12569,[],2017,12,1,10,2017-12-25 10:18:34
65,22726,22661,"['christmastree', 'Wimbledon', 'merrychristmas', 'Christmas']",2017,12,1,5,2017-12-25 05:54:13
75,18110,18035,"['sport', 'Wimbledon', 'instasport', 'tennis']",2017,12,0,12,2017-12-24 12:15:21
128,39458,39330,"['christmaseve', 'christmas', 'Wimbledon', 'tennis', 'sport', 'instasport']",2017,12,0,8,2017-12-24 08:27:25
372,37688,37316,"['sport', 'Wimbledon', 'instasport', 'tennis']",2017,12,6,16,2017-12-23 16:34:30
48,11593,11545,"['sport', 'Wimbledon', 'instasport', 'tennis']",2017,12,4,14,2017-12-21 14:57:31
81,16428,16347,['Wimbledon'],2017,12,3,12,2017-12-20 12:56:17
20,10857,10837,"['Wimbledon', 'night', 'tennis']",2017,12,2,14,2017-12-19 14:06:26
151,40076,39925,"['sport', 'Wimbledon', 'tennis']",2017,12,5,4,2017-12-15 04:10:20
83,14585,14502,"['Wimbledon', 'summer', 'sun', 'tennis']",2017,12,1,11,2017-12-11 11:12:46
64,13202,13138,"['Wimbledon', 'instasport', 'night', 'tennis']",2017,12,0,17,2017-12-10 17:00:13
17,12241,12224,"['Wimbledon', 'tennis', 'night', 'longexposure', 'instasport']",2017,12,6,16,2017-12-09 16:18:18
75,18089,18014,"['sport', 'Wimbledon', 'instasport', 'tennis']",2017,12,5,12,2017-12-08 12:54:04
83,22445,22362,"['sport', 'Wimbledon', 'instasport', 'tennis']",2017,12,4,12,2017-12-07 12:05:34
306,26254,25948,"['sport', 'Wimbledon', 'instasport', 'tennis']",2017,12,3,12,2017-12-06 12:43:17
66,13044,12978,"['grass', 'Wimbledon', 'tennis']",2017,12,2,7,2017-12-05 07:21:50
53,9166,9113,"['sport', 'Wimbledon', 'instasport', 'tennis']",2017,12,1,12,2017-12-04 12:03:52
41,12809,12768,"['NECMasters', 'Wimbledon', 'tennis', 'sport', 'instasport']",2017,12,0,18,2017-12-03 18:13:01
500,29351,28851,"['throwback', 'Wimbledon', 'tennis', 'tbt', 'instasport']",2017,11,4,12,2017-11-30 12:31:38
654,30298,29644,"['shadow', 'instasport', 'Wimbledon', 'silhouette', 'sport', 'tennis']",2017,11,4,7,2017-11-30 07:06:57
51,15422,15371,['Wimbledon'],2017,11,3,12,2017-11-29 12:56:58
86,14032,13946,[],2017,11,1,17,2017-11-27 17:06:29
168,14174,14006,['Wimbledon'],2017,11,3,12,2017-11-22 12:24:57
167,17447,17280,"['sport', 'Wimbledon', 'instasport', 'tennis']",2017,11,3,4,2017-11-22 04:43:32
70,20626,20556,"['sport', 'Wimbledon', 'instasport', 'tennis']",2017,11,2,12,2017-11-21 12:49:27
360,25400,25040,[],2017,11,1,6,2017-11-20 06:06:36
95,25619,25524,"['sport', 'Wimbledon', 'instasport', 'tennis']",2017,11,0,15,2017-11-19 15:48:36
260,51917,51657,"['wimbledon', 'sport', 'instasport', 'tennis']",2017,11,0,5,2017-11-19 05:17:08
565,49840,49275,"['wimbledon', 'sport', 'instasport', 'tennis']",2017,11,4,11,2017-11-16 11:25:21
1415,56060,54645,"['sport', 'Wimbledon', 'instasport', 'tennis']",2017,11,3,10,2017-11-15 10:01:20
170,29778,29608,['Wimbledon'],2017,11,1,18,2017-11-13 18:35:36
122,26513,26391,"['Wimbledon', 'tennis', 'sport', 'gardening', 'instasport']",2017,11,4,12,2017-11-09 12:05:34
229,40320,40091,['Wimbledon'],2017,11,3,8,2017-11-08 08:26:09
351,30347,29996,"['tennis', 'sport', 'wimbledon', 'mondaymotivation', 'instasport']",2017,11,1,12,2017-11-06 12:15:01
166,14926,14760,"['sport', 'Wimbledon', 'tennis', 'instasport']",2017,11,5,11,2017-11-03 11:27:41
311,28033,27722,"['sport', 'Wimbledon', 'instasport', 'tennis']",2017,11,3,11,2017-11-01 11:33:40
313,30333,30020,"['instasport', 'trickortreat', 'happyhalloween', 'Wimbledon', 'sport', 'Halloween', 'tennis']",2017,10,2,13,2017-10-31 13:29:45
81,16002,15921,"['Wimbledon', 'night', 'sport', 'dark', 'tennis']",2017,10,1,17,2017-10-30 17:48:03
196,41609,41413,"['sport', 'Wimbledon', 'instasport', 'tennis']",2017,10,0,12,2017-10-29 12:44:40
109,24257,24148,[],2017,10,0,9,2017-10-29 09:36:35
130,18876,18746,"['wimbledon', 'sport', 'tennis']",2017,10,6,16,2017-10-28 16:44:41
84,14193,14109,['Wimbledon'],2017,10,6,7,2017-10-28 07:35:43
108,15924,15816,"['sport', 'wimbledon', 'instasport', 'tennis']",2017,10,5,13,2017-10-27 13:58:21
61,14658,14597,['Wimbledon'],2017,10,4,12,2017-10-26 12:22:50
57,15147,15090,"['throwbackthursday', 'throwback', 'retro', 'TBT', 'Wimbledon', 'sport', 'tennis']",2017,10,4,7,2017-10-26 07:41:46
34,14928,14894,"['season', 'Wimbledon', 'Autumn', 'grass', 'tennis']",2017,10,3,9,2017-10-25 09:57:31
40,18266,18226,"['sport', 'Wimbledon', 'instasport', 'tennis']",2017,10,2,11,2017-10-24 11:12:58
75,23129,23054,[],2017,10,0,12,2017-10-22 12:38:27
87,15869,15782,"['sport', 'Wimbledon', 'instasport', 'tennis']",2017,10,0,5,2017-10-22 05:55:46
307,29880,29573,"['Wimbledon', 'tennis', 'sport', 'FBF', 'instasport']",2017,10,5,11,2017-10-20 11:19:41
118,22579,22461,"['instasport', 'throwback', 'retro', 'TBT', 'Wimbledon', 'sport', 'tennis']",2017,10,4,10,2017-10-19 10:39:41
61,16755,16694,['Wimbledon'],2017,10,3,15,2017-10-18 15:52:58
115,16985,16870,"['sport', 'Wimbledon', 'instasport', 'tennis']",2017,10,3,11,2017-10-18 11:29:31
75,17734,17659,"['redsun', 'Wimbledon', 'london', 'sky', 'redsky', 'tennis']",2017,10,1,11,2017-10-16 11:25:11
312,50138,49826,"['Wimbledon', 'tennis', 'sport', 'winning', 'instasport']",2017,10,0,6,2017-10-15 06:01:35
257,51842,51585,[],2017,10,6,10,2017-10-14 10:51:36
181,19431,19250,"['instasport', 'throwback', 'Wimbledon', 'tbt', 'sport', 'tennis']",2017,10,4,7,2017-10-12 07:46:01
128,21071,20943,"['autumn', 'ivy', 'Wimbledon', 'sport', 'autumnleaves', 'leaves', 'tennis']",2017,10,2,12,2017-10-10 12:53:37
134,23383,23249,"['sport', 'Wimbledon', 'instasport', 'tennis']",2017,10,0,13,2017-10-08 13:43:57
106,30068,29962,"['wimbledon', 'sport', 'tennis']",2017,10,0,9,2017-10-08 09:27:48
125,22784,22659,"['sport', 'Wimbledon', 'tennis']",2017,10,6,4,2017-10-07 04:34:11
117,39650,39533,"['WorldSmileDay', 'tennis', 'wimbledon', 'sport', 'instasport']",2017,10,5,9,2017-10-06 09:37:35
100,24481,24381,"['throwbackthursday', 'TBT', 'Wimbledon', 'tennis', 'tbt', 'instasport']",2017,10,4,7,2017-10-05 07:14:32
315,25355,25040,"['pug', 'WorldAnimalDay', 'dog', 'wimbledon', 'tennis']",2017,10,3,9,2017-10-04 09:06:43
95,17496,17401,"['skyline', 'skyscraper', 'London', 'wimbledon', 'cityscape', 'autumn', 'tennis']",2017,10,2,12,2017-10-03 12:10:28
80,12013,11933,"['sport', 'Wimbledon', 'tennis']",2017,10,1,16,2017-10-02 16:03:54
126,16207,16081,['Wimbledon'],2017,9,6,7,2017-09-30 07:36:19
91,15682,15591,['Wimbledon'],2017,9,4,13,2017-09-28 13:54:06
263,28891,28628,"['NationalPoetryDay', 'instasport', 'Wimbledon', 'sport', 'tennis']",2017,9,4,9,2017-09-28 09:15:56
136,18598,18462,"['sport', 'Wimbledon', 'instasport', 'tennis']",2017,9,3,11,2017-09-27 11:19:00
105,18049,17944,"['sport', 'Wimbledon', 'instasport', 'tennis']",2017,9,2,10,2017-09-26 10:11:01
30,21802,21772,"['motivation', 'tennis', 'wimbledon', 'sport', 'mondaymotivation', 'instasport']",2017,9,1,5,2017-09-25 05:00:08
429,51327,50898,"['LaverCup', 'Wimbledon', 'tennis', 'sport', 'instasport']",2017,9,6,5,2017-09-23 05:50:51
261,35309,35048,"['icon', 'tennis', 'wimbledon', 'sport', 'fbf', 'instasport']",2017,9,5,8,2017-09-22 08:09:42
160,16084,15924,"['wimbledon', 'leaves', 'autumn', 'tennis']",2017,9,1,10,2017-09-18 10:30:03
535,34185,33650,[],2017,9,4,12,2017-09-14 12:41:12
222,16241,16019,"['wimbledon', 'sport', 'tennis', 'instasport']",2017,9,3,14,2017-09-13 14:10:52
80,27973,27893,['Wimbledon'],2017,9,3,10,2017-09-13 10:20:35
110,19215,19105,"['tennis', 'wimbledon', 'sport', 'mondaymotivation', 'instasport']",2017,9,1,7,2017-09-11 07:22:00
272,46064,45792,"['wimbledon', 'sport', 'instasport', 'tennis']",2017,9,0,18,2017-09-10 18:54:53
43,17695,17652,"['sport', 'Wimbledon', 'instasport', 'tennis']",2017,9,0,12,2017-09-10 12:08:56
162,31679,31517,"['Wimbledon', 'usopen', 'tennis', 'sport', 'instasport']",2017,9,6,17,2017-09-09 17:24:03
83,36668,36585,[],2017,9,6,12,2017-09-09 12:36:58
92,28342,28250,"['wimbledon', 'sport', 'tennis', 'instasport']",2017,9,5,22,2017-09-08 22:29:39
93,13074,12981,"['sport', 'wimbledon', 'instasport', 'tennis']",2017,9,5,12,2017-09-08 12:19:28
211,34962,34751,"['wimbledon', 'sport', 'instasport', 'tennis']",2017,9,4,7,2017-09-07 07:35:22
106,26522,26416,"['sport', 'Wimbledon', 'instasport', 'tennis']",2017,9,3,14,2017-09-06 14:17:24
59,16390,16331,"['icon', 'motivation', 'wimbledon', 'sport', 'inspiration', 'tennis']",2017,9,3,12,2017-09-06 12:28:28
131,28427,28296,"['sport', 'Wimbledon', 'instasport', 'tennis']",2017,9,1,20,2017-09-04 20:25:53
104,17620,17516,"['wimbledon', 'sport', 'instasport', 'tennis']",2017,9,0,17,2017-09-03 17:02:01
157,17037,16880,"['sport', 'Wimbledon', 'instasport', 'tennis']",2017,9,5,10,2017-09-01 10:02:33
142,39990,39848,"['sport', 'wimbledon', 'instasport', 'tennis']",2017,8,4,18,2017-08-31 18:30:30
119,21437,21318,"['wimbledon', 'sport', 'instasport', 'tennis']",2017,8,3,10,2017-08-30 10:02:34
222,21404,21182,"['funny', 'sport', 'wimbledon', 'funnyvideos', 'tennis']",2017,8,2,12,2017-08-29 12:18:51
290,12851,12561,"['sport', 'wimbledon', 'instasport', 'tennis']",2017,8,0,18,2017-08-27 18:26:33
161,22300,22139,"['wimbledon', 'tennis']",2017,8,0,6,2017-08-27 06:48:38
158,24385,24227,"['sport', 'Wimbledon', 'instasport', 'tennis']",2017,8,5,11,2017-08-25 11:12:32
64,10057,9993,"['Wimbledon', 'construction', 'tennis']",2017,8,4,11,2017-08-24 11:40:07